,Date2,Y_up_predict,Y_down_predict,DateNum,up_percentage,close_open_diff,up_prediction_prob,down_prediction_prob,bet,PnL_original,Cum.Sum_original,open_low_diff,high_open_diff,PnL,Cum.Sum
0,1/3/2011,1,0,14977,1,206,0.802299887,0.197700113,1,206,206,117,295,206,206
1,1/4/2011,0,1,14978,0,283,0.212477535,0.787522435,-1,-283,-77,0,296,-200,6
2,1/5/2011,0,1,14979,0,152,0.350931987,0.649067998,-1,-152,-229,24,192,-152,-146
3,1/6/2011,0,1,14980,0,-32,0.297026515,0.702973485,-1,32,-197,118,11,32,-114
4,1/7/2011,0,1,14981,0,-55,0.163375974,0.836624026,-1,55,-142,117,130,55,-59
5,1/10/2011,0,1,14984,0,-139,0.337673649,0.662326306,-1,139,-3,176,157,139,80
6,1/11/2011,1,0,14985,1,183,0.63477248,0.36522752,1,183,180,74,301,183,263
7,1/12/2011,0,1,14986,0,383,0.377053678,0.622946322,-1,-383,-203,28,384,-200,63
8,1/13/2011,0,1,14987,0,-62,0.422794938,0.577205062,-1,62,-141,94,58,62,125
9,1/14/2011,0,1,14988,0,63,0.265448809,0.734551162,-1,-63,-204,87,69,-63,62
10,1/17/2011,0,1,14991,0,-159,0.36144495,0.63855505,-1,159,-45,276,25,159,221
11,1/18/2011,0,1,14992,0,-8,0.433204159,0.566795856,-1,8,-37,111,219,-200,21
12,1/19/2011,0,1,14993,0,44,0.449305475,0.550694525,-1,-44,-81,85,112,-44,-23
13,1/20/2011,0,1,14994,0,-228,0.31812942,0.68187061,-1,228,147,287,6,228,205
14,1/21/2011,0,1,14995,0,-136,0.167570844,0.832429171,-1,136,283,170,149,136,341
15,1/24/2011,1,0,14998,1,-219,0.543435991,0.456563979,1,-219,64,267,8,-200,141
16,1/25/2011,1,0,14999,1,-134,0.677279294,0.322720677,1,-134,-70,140,110,-134,7
17,1/26/2011,1,0,15000,1,46,0.516367286,0.483632714,1,46,-24,159,200,46,53
18,1/27/2011,0,1,15001,0,9,0.293960556,0.706039429,-1,-9,-33,50,273,-200,-147
19,1/28/2011,0,1,15002,0,-155,0.386124074,0.613875896,-1,155,122,247,3,155,8
20,1/31/2011,1,0,15005,1,91,0.569310546,0.430689454,1,91,213,23,259,91,99
21,2/1/2011,1,0,15006,1,17,0.522955865,0.477044135,1,17,230,44,91,17,116
22,2/2/2011,0,1,15007,0,306,0.388178512,0.611821532,-1,-306,-76,15,311,-200,-84
23,2/7/2011,0,1,15012,0,-493,0.167720243,0.832279772,-1,493,417,542,10,493,409
24,2/8/2011,0,1,15013,0,-219,0.263579935,0.736420006,-1,219,636,243,15,219,628
25,2/9/2011,0,1,15014,0,-379,0.272203863,0.727796137,-1,379,1015,383,116,379,1007
26,2/10/2011,1,0,15015,1,-351,0.584810674,0.415189311,1,-351,664,437,4,-200,807
27,2/11/2011,0,1,15016,0,52,0.434084043,0.565915942,-1,-52,612,274,142,-52,755
28,2/14/2011,1,0,15019,1,213,0.737919152,0.262080833,1,213,825,12,295,213,968
29,2/15/2011,1,0,15020,1,-91,0.566552073,0.433447972,1,-91,734,159,63,-91,877
30,2/16/2011,1,0,15021,1,123,0.718452483,0.281547472,1,123,857,184,220,123,1000
31,2/17/2011,0,1,15022,0,115,0.332679987,0.667320013,-1,-115,742,131,125,-115,885
32,2/18/2011,1,0,15023,1,291,0.741887122,0.258112893,1,291,1033,18,327,291,1176
33,2/21/2011,1,0,15026,1,-63,0.775849015,0.224151023,1,-63,970,79,60,-63,1113
34,2/22/2011,0,1,15027,0,-258,0.481914356,0.518085659,-1,258,1228,281,0,258,1371
35,2/23/2011,1,0,15028,1,-9,0.829745799,0.170254223,1,-9,1219,113,82,-9,1362
36,2/24/2011,1,0,15029,1,-218,0.683825552,0.316174418,1,-218,1001,326,181,-200,1162
37,2/25/2011,1,0,15030,1,200,0.754216582,0.245783418,1,200,1201,14,211,200,1362
38,2/28/2011,1,0,15033,1,448,0.609017551,0.390982509,1,448,1649,78,508,448,1810
39,3/1/2011,0,1,15034,0,80,0.322849929,0.677150071,-1,-80,1569,108,144,-80,1730
40,3/2/2011,0,1,15035,0,-127,0.378684729,0.621315241,-1,127,1696,245,68,127,1857
41,3/3/2011,1,0,15036,1,-32,0.734404922,0.265595064,1,-32,1664,39,258,-32,1825
42,3/4/2011,0,1,15037,0,5,0.227989405,0.772010595,-1,-5,1659,19,158,-5,1820
43,3/7/2011,1,0,15040,1,167,0.776473612,0.223526344,1,167,1826,71,291,167,1987
44,3/8/2011,1,0,15041,1,477,0.547263086,0.452736959,1,477,2303,46,488,477,2464
45,3/9/2011,0,1,15042,0,-60,0.287127405,0.712872565,-1,60,2363,77,83,60,2524
46,3/10/2011,1,0,15043,1,-156,0.584451377,0.415548623,1,-156,2207,283,1,-200,2324
47,3/11/2011,1,0,15044,1,-208,0.802214831,0.197785147,1,-208,1999,384,67,-200,2124
48,3/14/2011,1,0,15047,1,165,0.57816726,0.421832711,1,165,2164,107,200,165,2289
49,3/15/2011,1,0,15048,1,-502,0.858016044,0.141983949,1,-502,1662,905,53,-200,2089
50,3/16/2011,1,0,15049,1,7,0.856918395,0.143081598,1,7,1669,107,176,7,2096
51,3/17/2011,1,0,15050,1,-98,0.794487715,0.205512278,1,-98,1571,171,203,-98,1998
52,3/18/2011,0,1,15051,0,-122,0.166864403,0.833135605,-1,122,1693,136,66,122,2120
53,3/21/2011,1,0,15054,1,132,0.510237575,0.489762411,1,132,1825,138,196,132,2252
54,3/22/2011,0,1,15055,0,171,0.277354464,0.722645462,-1,-171,1654,32,240,-200,2052
55,3/23/2011,1,0,15056,1,64,0.524258405,0.47574161,1,64,1718,66,87,64,2116
56,3/24/2011,1,0,15057,1,41,0.584032506,0.415967584,1,41,1759,45,285,41,2157
57,3/25/2011,1,0,15058,1,-18,0.622732311,0.377267748,1,-18,1741,132,38,-18,2139
58,3/28/2011,0,1,15061,0,-37,0.468702152,0.531297922,-1,37,1778,157,189,37,2176
59,3/29/2011,0,1,15062,0,61,0.389732301,0.610267729,-1,-61,1717,39,153,-61,2115
60,3/30/2011,1,0,15063,1,192,0.540192544,0.459807456,1,192,1909,22,225,192,2307
61,3/31/2011,0,1,15064,0,1,0.380826667,0.619173348,-1,-1,1908,57,81,-1,2306
62,4/1/2011,1,0,15065,1,250,0.777670056,0.222329959,1,250,2158,116,259,250,2556
63,4/4/2011,1,0,15068,1,241,0.714663237,0.285336703,1,241,2399,44,253,241,2797
64,4/6/2011,1,0,15070,1,64,0.610434204,0.389565825,1,64,2463,119,110,64,2861
65,4/7/2011,0,1,15071,0,-16,0.400940448,0.599059522,-1,16,2479,109,62,16,2877
66,4/8/2011,0,1,15072,0,106,0.464798748,0.535201281,-1,-106,2373,63,170,-106,2771
67,4/11/2011,0,1,15075,0,-71,0.402851939,0.597148031,-1,71,2444,177,69,71,2842
68,4/12/2011,0,1,15076,0,-232,0.399552062,0.600447923,-1,232,2676,280,5,232,3074
69,4/13/2011,1,0,15077,1,177,0.748761564,0.251238436,1,177,2853,90,278,177,3251
70,4/14/2011,0,1,15078,0,13,0.248091668,0.751908302,-1,-13,2840,110,72,-13,3238
71,4/15/2011,0,1,15079,0,-137,0.279154986,0.720845044,-1,137,2977,229,155,137,3375
72,4/18/2011,1,0,15082,1,-157,0.740991503,0.259008467,1,-157,2820,214,222,-200,3175
73,4/19/2011,0,1,15083,0,-205,0.490690321,0.509309679,-1,205,3025,223,14,205,3380
74,4/20/2011,1,0,15084,1,215,0.607252836,0.392747179,1,215,3240,45,219,215,3595
75,4/21/2011,0,1,15085,0,41,0.23666662,0.76333338,-1,-41,3199,30,139,-41,3554
76,4/26/2011,0,1,15090,0,-25,0.487872556,0.512127459,-1,25,3224,169,110,25,3579
77,4/27/2011,1,0,15091,1,-339,0.601685673,0.398314297,1,-339,2885,374,120,-200,3379
78,4/28/2011,0,1,15092,0,-87,0.347050712,0.652949333,-1,87,2972,95,121,87,3466
79,4/29/2011,1,0,15093,1,-68,0.709538281,0.290461749,1,-68,2904,101,114,-68,3398
80,5/3/2011,0,1,15097,0,-206,0.389282539,0.610717475,-1,206,3110,210,190,206,3604
81,5/4/2011,0,1,15098,0,-273,0.232190602,0.767809391,-1,273,3383,300,49,273,3877
82,5/5/2011,0,1,15099,0,50,0.315575361,0.684424669,-1,-50,3333,81,98,-50,3827
83,5/6/2011,0,1,15100,0,138,0.323884323,0.676115692,-1,-138,3195,27,223,-200,3627
84,5/9/2011,0,1,15103,0,105,0.185452156,0.814547867,-1,-105,3090,25,179,-105,3522
85,5/11/2011,0,1,15105,0,-180,0.263912216,0.736087799,-1,180,3270,238,94,180,3702
86,5/12/2011,0,1,15106,0,-105,0.384639561,0.615360439,-1,105,3375,132,40,105,3807
87,5/13/2011,0,1,15107,0,333,0.327232197,0.672767818,-1,-333,3042,139,404,-200,3607
88,5/16/2011,1,0,15110,1,-159,0.511679828,0.488320157,1,-159,2883,163,131,-159,3448
89,5/17/2011,1,0,15111,1,16,0.511329681,0.488670334,1,16,2899,110,119,16,3464
90,5/18/2011,1,0,15112,1,89,0.727687895,0.272312149,1,89,2988,19,170,89,3553
91,5/19/2011,0,1,15113,0,113,0.441838682,0.558161288,-1,-113,2875,55,204,-200,3353
92,5/20/2011,0,1,15114,0,-52,0.22826384,0.771736115,-1,52,2927,84,42,52,3405
93,5/23/2011,1,0,15117,1,-232,0.702142805,0.297857195,1,-232,2695,265,17,-200,3205
94,5/24/2011,1,0,15118,1,9,0.759159952,0.240840048,1,9,2704,64,71,9,3214
95,5/25/2011,1,0,15119,1,153,0.729215741,0.270784214,1,153,2857,126,195,153,3367
96,5/26/2011,1,0,15120,1,21,0.646155775,0.35384424,1,21,2878,37,143,21,3388
97,5/27/2011,1,0,15121,1,219,0.785045326,0.214954637,1,219,3097,38,262,219,3607
98,5/30/2011,0,1,15124,0,102,0.410950452,0.589049548,-1,-102,2995,25,135,-102,3505
99,5/31/2011,1,0,15125,1,330,0.506104171,0.493895844,1,330,3325,0,401,330,3835
100,6/1/2011,0,1,15126,0,-71,0.297028109,0.702971876,-1,71,3396,100,25,71,3906
101,6/2/2011,1,0,15127,1,28,0.65068984,0.349310145,1,28,3424,40,110,28,3934
102,6/3/2011,0,1,15128,0,-266,0.418128088,0.581871957,-1,266,3690,343,28,266,4200
103,6/7/2011,0,1,15132,0,109,0.249933779,0.750066221,-1,-109,3581,56,168,-109,4091
104,6/8/2011,1,0,15133,1,-170,0.524508446,0.475491554,1,-170,3411,207,13,-200,3891
105,6/9/2011,0,1,15134,0,-68,0.433352128,0.566647917,-1,68,3479,267,52,68,3959
106,6/10/2011,0,1,15135,0,-287,0.390307844,0.609692156,-1,287,3766,347,37,287,4246
107,6/13/2011,1,0,15138,1,312,0.597942412,0.402057588,1,312,4078,23,355,312,4558
108,6/14/2011,0,1,15139,0,225,0.223068833,0.776931196,-1,-225,3853,25,351,-200,4358
109,6/15/2011,0,1,15140,0,-272,0.310994998,0.689004987,-1,272,4125,280,27,272,4630
110,6/16/2011,1,0,15141,1,-119,0.747611701,0.252388321,1,-119,4006,194,17,-119,4511
111,6/17/2011,0,1,15142,0,-352,0.255557835,0.744442165,-1,352,4358,361,32,352,4863
112,6/20/2011,0,1,15145,0,-74,0.342124864,0.657875121,-1,74,4432,211,178,74,4937
113,6/21/2011,1,0,15146,1,45,0.514540732,0.485459268,1,45,4477,138,82,45,4982
114,6/22/2011,1,0,15147,1,-168,0.554285705,0.44571428,1,-168,4309,194,45,-168,4814
115,6/23/2011,0,1,15148,0,-93,0.406129718,0.593870312,-1,93,4402,161,142,93,4907
116,6/24/2011,1,0,15149,1,343,0.834102064,0.165897965,1,343,4745,45,368,343,5250
117,6/27/2011,1,0,15152,1,157,0.580334872,0.419665128,1,157,4902,4,248,157,5407
118,6/28/2011,0,1,15153,0,-113,0.319665998,0.680334032,-1,113,5015,175,104,113,5520
119,6/29/2011,0,1,15154,0,-123,0.34643203,0.65356797,-1,123,5138,136,39,123,5643
120,6/30/2011,1,0,15155,1,223,0.620555013,0.379444972,1,223,5361,37,281,223,5866
121,7/4/2011,0,1,15159,0,-55,0.499017894,0.500982046,-1,55,5416,161,0,55,5921
122,7/5/2011,0,1,15160,0,-89,0.390664473,0.609335512,-1,89,5505,145,11,89,6010
123,7/6/2011,0,1,15161,0,-214,0.450881138,0.549118817,-1,214,5719,214,88,214,6224
124,7/7/2011,0,1,15162,0,-4,0.405976534,0.594023436,-1,4,5723,41,187,4,6228
125,7/8/2011,0,1,15163,0,88,0.222883321,0.777116716,-1,-88,5635,31,154,-88,6140
126,7/11/2011,1,0,15166,1,-216,0.756953984,0.243046053,1,-216,5419,283,28,-200,5940
127,7/12/2011,1,0,15167,1,-517,0.643556714,0.356443286,1,-517,4902,548,6,-200,5740
128,7/13/2011,1,0,15168,1,120,0.627161086,0.37283887,1,120,5022,76,184,120,5860
129,7/14/2011,0,1,15169,0,10,0.440993205,0.55900681,-1,-10,5012,258,13,-10,5850
130,7/15/2011,0,1,15170,0,-26,0.210066058,0.78993392,-1,26,5038,112,106,26,5876
131,7/18/2011,1,0,15173,1,57,0.597830355,0.402169675,1,57,5095,45,293,57,5933
132,7/19/2011,1,0,15174,1,60,0.542677194,0.457322821,1,60,5155,188,138,60,5993
133,7/20/2011,1,0,15175,1,-152,0.54030928,0.45969075,1,-152,5003,275,22,-200,5793
134,7/21/2011,0,1,15176,0,-101,0.192238286,0.807761699,-1,101,5104,226,53,101,5894
135,7/22/2011,0,1,15177,0,269,0.430626854,0.569373161,-1,-269,4835,10,277,-200,5694
136,7/25/2011,1,0,15180,1,-10,0.657448113,0.342551872,1,-10,4825,116,33,-10,5684
137,7/26/2011,1,0,15181,1,240,0.635047644,0.364952356,1,240,5065,36,292,240,5924
138,7/27/2011,0,1,15182,0,126,0.484574899,0.515425056,-1,-126,4939,0,220,-200,5724
139,7/28/2011,0,1,15183,0,39,0.401820287,0.598179668,-1,-39,4900,67,91,-39,5685
140,7/29/2011,1,0,15184,1,-194,0.524308205,0.475691795,1,-194,4706,261,76,-200,5485
141,8/1/2011,1,0,15187,1,57,0.834890902,0.165109098,1,57,4763,0,208,57,5542
142,8/2/2011,1,0,15188,1,-104,0.511320114,0.488679916,1,-104,4659,202,84,-200,5342
143,8/3/2011,0,1,15189,0,10,0.425218523,0.574781477,-1,-10,4649,109,55,-10,5332
144,8/4/2011,0,1,15190,0,-295,0.19213783,0.807862192,-1,295,4944,355,29,295,5627
145,8/5/2011,1,0,15191,1,-54,0.631425917,0.368574098,1,-54,4890,237,149,-200,5427
146,8/8/2011,0,1,15194,0,170,0.165563136,0.834436864,-1,-170,4720,253,294,-200,5227
147,8/9/2011,1,0,15195,1,344,0.742463768,0.257536262,1,344,5064,281,1046,-200,5027
148,8/10/2011,0,1,15196,0,-275,0.461721212,0.538278818,-1,275,5339,425,110,275,5302
149,8/11/2011,1,0,15197,1,31,0.819642931,0.180357091,1,31,5370,175,298,31,5333
150,8/12/2011,0,1,15198,0,-141,0.157867156,0.842132807,-1,141,5511,201,184,141,5474
151,8/15/2011,1,0,15201,1,293,0.810968488,0.189031497,1,293,5804,40,335,293,5767
152,8/16/2011,0,1,15202,0,-96,0.298691377,0.701308638,-1,96,5900,172,147,96,5863
153,8/17/2011,1,0,15203,1,-144,0.621303588,0.378696382,1,-144,5756,168,176,-144,5719
154,8/18/2011,1,0,15204,1,-197,0.743504703,0.256495252,1,-197,5559,238,145,-200,5519
155,8/19/2011,0,1,15205,0,-98,0.424947113,0.575052887,-1,98,5657,169,153,98,5617
156,8/22/2011,1,0,15208,1,289,0.834915519,0.165084451,1,289,5946,206,425,-200,5417
157,8/23/2011,0,1,15209,0,436,0.217602931,0.782397091,-1,-436,5510,66,454,-200,5217
158,8/24/2011,0,1,15210,0,-520,0.214589402,0.785410613,-1,520,6030,533,5,520,5737
159,8/25/2011,0,1,15211,0,46,0.176934645,0.8230654,-1,-46,5984,116,49,-46,5691
160,8/26/2011,1,0,15212,1,-254,0.594013155,0.405986831,1,-254,5730,267,149,-200,5491
161,8/29/2011,0,1,15215,0,45,0.36176163,0.638238341,-1,-45,5685,60,124,-45,5446
162,8/30/2011,0,1,15216,0,67,0.263477594,0.736522406,-1,-67,5618,44,168,-67,5379
163,8/31/2011,1,0,15217,1,267,0.714955062,0.285044923,1,267,5885,141,278,267,5646
164,9/1/2011,0,1,15218,0,-199,0.400103316,0.59989661,-1,199,6084,205,336,-200,5446
165,9/2/2011,1,0,15219,1,-289,0.753430277,0.246569708,1,-289,5795,306,97,-200,5246
166,9/5/2011,1,0,15222,1,-253,0.797905564,0.202094465,1,-253,5542,346,6,-200,5046
167,9/6/2011,0,1,15223,0,439,0.456229463,0.543770522,-1,-439,5103,76,541,-200,4846
168,9/7/2011,1,0,15224,1,145,0.840829939,0.159170046,1,145,5248,121,183,145,4991
169,9/8/2011,0,1,15225,0,-243,0.252953507,0.7470465,-1,243,5491,370,45,243,5234
170,9/9/2011,1,0,15226,1,-204,0.804316282,0.195683733,1,-204,5287,205,145,-200,5034
171,9/12/2011,1,0,15229,1,-204,0.602053344,0.397946641,1,-204,5083,276,56,-200,4834
172,9/14/2011,0,1,15231,0,-253,0.251971528,0.748028427,-1,253,5336,650,32,253,5087
173,9/15/2011,0,1,15232,0,-34,0.420092136,0.579907894,-1,34,5370,340,40,34,5121
174,9/16/2011,0,1,15233,0,-208,0.287585184,0.712414801,-1,208,5578,209,136,208,5329
175,9/19/2011,0,1,15236,0,-298,0.195811868,0.804188132,-1,298,5876,392,45,298,5627
176,9/20/2011,1,0,15237,1,-34,0.776433259,0.223566778,1,-34,5842,312,37,-200,5427
177,9/21/2011,0,1,15238,0,-165,0.433000788,0.566999197,-1,165,6007,213,148,165,5592
178,9/22/2011,0,1,15239,0,-357,0.494054809,0.505945176,-1,357,6364,425,75,357,5949
179,9/23/2011,1,0,15240,1,187,0.616369903,0.383630127,1,187,6551,202,253,-200,5749
180,9/26/2011,1,0,15243,1,-208,0.533735335,0.466264606,1,-208,6343,637,107,-200,5549
181,9/27/2011,1,0,15244,1,193,0.620567173,0.379432857,1,193,6536,118,240,193,5742
182,9/28/2011,0,1,15245,0,84,0.274600357,0.725399643,-1,-84,6452,51,203,-200,5542
183,9/30/2011,0,1,15247,0,-522,0.240893938,0.7591061,-1,522,6974,532,0,522,6064
184,10/3/2011,1,0,15250,1,-53,0.643992335,0.35600771,1,-53,6921,234,147,-200,5864
185,10/4/2011,1,0,15251,1,-417,0.763724327,0.236275665,1,-417,6504,535,183,-200,5664
186,10/6/2011,1,0,15253,1,263,0.537120402,0.462879598,1,263,6767,123,274,263,5927
187,10/7/2011,1,0,15254,1,222,0.696031213,0.303968772,1,222,6989,21,356,222,6149
188,10/10/2011,0,1,15257,0,-131,0.209482402,0.790517628,-1,131,7120,478,40,131,6280
189,10/11/2011,1,0,15258,1,-354,0.537807703,0.462192342,1,-354,6766,360,78,-200,6080
190,10/12/2011,1,0,15259,1,572,0.693830609,0.306169391,1,572,7338,110,572,572,6652
191,10/13/2011,1,0,15260,1,-24,0.577896148,0.422103837,1,-24,7314,254,110,-200,6452
192,10/14/2011,0,1,15261,0,-198,0.373181462,0.626818538,-1,198,7512,297,36,198,6650
193,10/17/2011,1,0,15264,1,-46,0.504194111,0.495805919,1,-46,7466,210,50,-200,6450
194,10/18/2011,0,1,15265,0,-216,0.36972402,0.630275965,-1,216,7682,423,70,216,6666
195,10/19/2011,1,0,15266,1,-100,0.741951376,0.258048601,1,-100,7582,209,43,-200,6466
196,10/20/2011,1,0,15267,1,-97,0.570572495,0.429427505,1,-97,7485,411,12,-200,6266
197,10/21/2011,0,1,15268,0,-87,0.476891592,0.523108453,-1,87,7572,131,50,87,6353
198,10/24/2011,0,1,15271,0,501,0.415845945,0.584154069,-1,-501,7071,17,516,-200,6153
199,10/25/2011,1,0,15272,1,206,0.786784232,0.213215798,1,206,7277,47,211,206,6359
200,10/26/2011,1,0,15273,1,270,0.787844747,0.212155223,1,270,7547,43,368,270,6629
201,10/27/2011,0,1,15274,0,674,0.291085705,0.70891431,-1,-674,6873,127,675,-200,6429
202,10/28/2011,0,1,15275,0,-48,0.168640271,0.831359744,-1,48,6921,100,122,48,6477
203,10/31/2011,1,0,15278,1,-216,0.833519191,0.166480787,1,-216,6705,336,139,-200,6277
204,11/1/2011,1,0,15279,1,-133,0.724507719,0.275492266,1,-133,6572,189,252,-133,6144
205,11/2/2011,1,0,15280,1,633,0.836700529,0.163299434,1,633,7205,147,654,633,6777
206,11/3/2011,0,1,15281,0,-141,0.438123137,0.561876833,-1,141,7346,368,83,141,6918
207,11/4/2011,0,1,15282,0,60,0.178299367,0.821700633,-1,-60,7286,90,141,-60,6858
208,11/7/2011,1,0,15285,1,-301,0.709170818,0.290829137,1,-301,6985,309,66,-200,6658
209,11/8/2011,0,1,15286,0,50,0.396934122,0.603065878,-1,-50,6935,144,164,-50,6608
210,11/9/2011,0,1,15287,0,-109,0.242865264,0.757134765,-1,109,7044,136,124,109,6717
211,11/10/2011,0,1,15288,0,-17,0.345382348,0.654617667,-1,17,7061,165,141,17,6734
212,11/11/2011,0,1,15289,0,-52,0.204006396,0.795993596,-1,52,7113,149,63,52,6786
213,11/14/2011,0,1,15292,0,-87,0.404298395,0.595701575,-1,87,7200,104,70,87,6873
214,11/15/2011,0,1,15293,0,-85,0.347235128,0.652764916,-1,85,7285,187,18,85,6958
215,11/16/2011,0,1,15294,0,-548,0.258916482,0.741083503,-1,548,7833,727,10,548,7506
216,11/17/2011,1,0,15295,1,362,0.702932537,0.297067434,1,362,8195,0,408,362,7868
217,11/18/2011,0,1,15296,0,-11,0.238929756,0.761070222,-1,11,8206,115,52,11,7879
218,11/21/2011,1,0,15299,1,-50,0.662675858,0.337324113,1,-50,8156,155,113,-50,7829
219,11/22/2011,1,0,15300,1,70,0.730754018,0.269245997,1,70,8226,133,245,70,7899
220,11/23/2011,1,0,15301,1,-97,0.666894108,0.333105907,1,-97,8129,111,62,-97,7802
221,11/24/2011,1,0,15302,1,203,0.64490822,0.35509181,1,203,8332,58,330,203,8005
222,11/25/2011,0,1,15303,0,43,0.497756928,0.502243042,-1,-43,8289,34,226,-200,7805
223,11/28/2011,0,1,15306,0,-68,0.217887767,0.782112241,-1,68,8357,151,14,68,7873
224,11/29/2011,0,1,15307,0,21,0.332571536,0.667428464,-1,-21,8336,131,51,-21,7852
225,11/30/2011,0,1,15308,0,-79,0.39331767,0.60668236,-1,79,8415,343,2,79,7931
226,12/1/2011,0,1,15309,0,-125,0.209813215,0.790186763,-1,125,8540,181,30,125,8056
227,12/2/2011,1,0,15310,1,174,0.523952007,0.476047993,1,174,8714,138,179,174,8230
228,12/5/2011,1,0,15313,1,-14,0.740596443,0.259403586,1,-14,8700,160,75,-14,8216
229,12/6/2011,0,1,15314,0,37,0.320094272,0.679905742,-1,-37,8663,202,53,-37,8179
230,12/7/2011,1,0,15315,1,109,0.555760533,0.444239497,1,109,8772,98,187,109,8288
231,12/8/2011,0,1,15316,0,-2,0.476822868,0.523177147,-1,2,8774,163,63,2,8290
232,12/9/2011,0,1,15317,0,-144,0.302935079,0.697064877,-1,144,8918,223,131,144,8434
233,12/12/2011,0,1,15320,0,-410,0.308587149,0.691412866,-1,410,9328,434,26,410,8844
234,12/13/2011,1,0,15321,1,92,0.773027658,0.226972327,1,92,9420,83,136,92,8936
235,12/14/2011,0,1,15322,0,-57,0.431630835,0.56836921,-1,57,9477,65,156,57,8993
236,12/15/2011,0,1,15323,0,-94,0.425813079,0.574186891,-1,94,9571,201,66,94,9087
237,12/16/2011,0,1,15324,0,297,0.203131445,0.796868593,-1,-297,9274,0,434,-200,8887
238,12/19/2011,0,1,15327,0,59,0.32140854,0.67859146,-1,-59,9215,232,91,-59,8828
239,12/20/2011,1,0,15328,1,-52,0.592977881,0.407022119,1,-52,9163,65,259,-52,8776
240,12/21/2011,0,1,15329,0,-46,0.260527313,0.739472657,-1,46,9209,170,72,46,8822
241,12/22/2011,1,0,15330,1,114,0.621682763,0.378317252,1,114,9323,76,119,114,8936
242,12/23/2011,0,1,15331,0,-1,0.447198391,0.552801579,-1,1,9324,28,58,1,8937
243,12/28/2011,0,1,15336,0,-150,0.361725211,0.638274729,-1,150,9474,222,19,150,9087
244,12/29/2011,0,1,15337,0,92,0.459575519,0.540424436,-1,-92,9382,29,100,-92,8995
245,12/30/2011,0,1,15338,0,-23,0.32722044,0.67277953,-1,23,9405,119,20,23,9018
0,1/3/2012,0,1,15342,0,-37,0.497215971,0.502783969,-1,37,37,117,33,37,37
1,1/4/2012,0,1,15343,0,-94,0.329797179,0.670202792,-1,94,131,170,54,94,131
2,1/5/2012,1,0,15344,1,37,0.519081414,0.480918601,1,37,168,48,67,37,168
3,1/6/2012,1,0,15345,1,-121,0.623444766,0.376555264,1,-121,47,298,10,-200,-32
4,1/9/2012,0,1,15348,0,329,0.374538988,0.625460982,-1,-329,-282,325,337,-200,-232
5,1/10/2012,1,0,15349,1,-43,0.519646078,0.480353951,1,-43,-325,177,66,-43,-275
6,1/11/2012,0,1,15350,0,120,0.259269506,0.740730494,-1,-120,-445,89,144,-120,-395
7,1/12/2012,1,0,15351,1,-5,0.698894352,0.301105663,1,-5,-450,50,166,-5,-400
8,1/13/2012,1,0,15352,1,12,0.524364173,0.475635797,1,12,-438,196,16,12,-388
9,1/16/2012,1,0,15355,1,3,0.647799432,0.352200508,1,3,-435,49,46,3,-385
10,1/17/2012,1,0,15356,1,538,0.521477342,0.478522673,1,538,103,10,549,538,153
11,1/18/2012,0,1,15357,0,-57,0.459768459,0.540231556,-1,57,160,58,93,57,210
12,1/19/2012,1,0,15358,1,190,0.718068749,0.281931266,1,190,350,12,202,190,400
13,1/20/2012,0,1,15359,0,117,0.215597212,0.784402788,-1,-117,233,121,141,-117,283
14,1/26/2012,1,0,15365,1,-90,0.761026323,0.23897367,1,-90,143,188,0,-90,193
15,1/27/2012,0,1,15366,0,254,0.413321897,0.586678088,-1,-254,-111,0,266,-200,-7
16,1/30/2012,1,0,15369,1,-160,0.709092706,0.290907323,1,-160,-271,160,0,-160,-167
17,1/31/2012,0,1,15370,0,12,0.454469517,0.545530498,-1,-12,-283,80,169,-12,-179
18,2/1/2012,0,1,15371,0,21,0.433180392,0.566819578,-1,-21,-304,70,214,-200,-379
19,2/2/2012,0,1,15372,0,111,0.325821877,0.674178123,-1,-111,-415,69,117,-111,-490
20,2/3/2012,0,1,15373,0,26,0.438153461,0.561846554,-1,-26,-441,77,88,-26,-516
21,2/6/2012,0,1,15376,0,-339,0.206234552,0.793765396,-1,339,-102,350,8,339,-177
22,2/7/2012,1,0,15377,1,-63,0.682793319,0.317206621,1,-63,-165,169,80,-63,-240
23,2/8/2012,0,1,15378,0,284,0.344540983,0.655459017,-1,-284,-449,75,291,-200,-440
24,2/9/2012,0,1,15379,0,0,0.272187307,0.727812678,-1,0,-449,164,136,0,-440
25,2/10/2012,0,1,15380,0,-205,0.195477776,0.804522187,-1,205,-244,300,8,205,-235
26,2/13/2012,1,0,15383,1,116,0.545472175,0.454527795,1,116,-128,72,227,116,-119
27,2/14/2012,0,1,15384,0,110,0.256541312,0.743458688,-1,-110,-238,46,125,-110,-229
28,2/15/2012,0,1,15385,0,391,0.283142671,0.716857374,-1,-391,-629,94,418,-200,-429
29,2/16/2012,0,1,15386,0,-16,0.208362289,0.791637689,-1,16,-613,56,92,16,-413
30,2/17/2012,0,1,15387,0,-46,0.339421362,0.660578609,-1,46,-567,78,84,46,-367
31,2/20/2012,0,1,15390,0,-381,0.23075746,0.769242465,-1,381,-186,389,20,381,14
32,2/21/2012,0,1,15391,0,2,0.318492249,0.681507766,-1,-2,-188,211,72,-2,12
33,2/22/2012,0,1,15392,0,162,0.214089759,0.785910219,-1,-162,-350,67,242,-200,-188
34,2/23/2012,0,1,15393,0,24,0.335777178,0.664222807,-1,-24,-374,46,93,-24,-212
35,2/24/2012,0,1,15394,0,-84,0.421904966,0.578095049,-1,84,-290,202,8,84,-128
36,2/27/2012,0,1,15397,0,-195,0.272086799,0.727913171,-1,195,-95,352,218,-200,-328
37,2/28/2012,0,1,15398,0,167,0.402479738,0.597520292,-1,-167,-262,0,178,-167,-495
38,2/29/2012,0,1,15399,0,47,0.226287529,0.773712486,-1,-47,-309,128,95,-47,-542
39,3/1/2012,0,1,15400,0,-164,0.199112251,0.800887734,-1,164,-145,208,139,164,-378
40,3/2/2012,0,1,15401,0,1,0.216203615,0.78379637,-1,-1,-146,49,63,-1,-379
41,3/5/2012,0,1,15404,0,-305,0.395063698,0.604936272,-1,305,159,340,73,305,-74
42,3/6/2012,0,1,15405,0,-410,0.194076039,0.805923909,-1,410,569,416,46,410,336
43,3/7/2012,0,1,15406,0,112,0.419344634,0.580655366,-1,-112,457,13,217,-200,136
44,3/8/2012,0,1,15407,0,216,0.319183141,0.680816889,-1,-216,241,28,245,-200,-64
45,3/9/2012,0,1,15408,0,218,0.275343612,0.724656373,-1,-218,23,26,320,-200,-264
46,3/12/2012,0,1,15411,0,94,0.337894231,0.662105799,-1,-94,-71,179,112,-94,-358
47,3/13/2012,0,1,15412,0,-42,0.249277718,0.750722289,-1,42,-29,87,90,42,-316
48,3/14/2012,0,1,15413,0,-268,0.408812463,0.591187507,-1,268,239,290,120,268,-48
49,3/15/2012,0,1,15414,0,37,0.178333536,0.821666479,-1,-37,202,113,106,-37,-85
50,3/16/2012,0,1,15415,0,58,0.374238089,0.625761867,-1,-58,144,25,190,-58,-143
51,3/19/2012,0,1,15418,0,-482,0.490536511,0.509463519,-1,482,626,489,7,482,339
52,3/20/2012,0,1,15419,0,-234,0.387248844,0.612751126,-1,234,860,368,25,234,573
53,3/21/2012,1,0,15420,1,-91,0.603490055,0.396509901,1,-91,769,266,25,-200,373
54,3/22/2012,1,0,15421,1,-15,0.683023661,0.316976368,1,-15,754,111,92,-15,358
55,3/23/2012,0,1,15422,0,-163,0.463782281,0.536217779,-1,163,917,202,5,163,521
56,3/26/2012,1,0,15425,1,52,0.765908152,0.234091818,1,52,969,125,116,52,573
57,3/27/2012,0,1,15426,0,190,0.370582536,0.629417509,-1,-190,779,48,198,-190,383
58,3/28/2012,0,1,15427,0,-154,0.410021126,0.589978874,-1,154,933,257,0,154,537
59,3/29/2012,0,1,15428,0,-73,0.345916092,0.654083908,-1,73,1006,103,0,73,610
60,3/30/2012,1,0,15429,1,129,0.69423151,0.30576852,1,129,1135,11,167,129,739
61,4/2/2012,0,1,15432,0,-130,0.386601284,0.613398701,-1,130,1265,201,57,130,869
62,4/3/2012,1,0,15433,1,136,0.728792429,0.271207571,1,136,1401,99,176,136,1005
63,4/5/2012,0,1,15435,0,145,0.489670753,0.510329247,-1,-145,1256,0,297,-200,805
64,4/10/2012,1,0,15440,1,-56,0.690550268,0.309449732,1,-56,1200,104,84,-56,749
65,4/11/2012,1,0,15441,1,-5,0.593073964,0.406926066,1,-5,1195,98,59,-5,744
66,4/12/2012,0,1,15442,0,299,0.293710604,0.706289381,-1,-299,896,8,300,-200,544
67,4/13/2012,1,0,15443,1,92,0.595493764,0.404506251,1,92,988,70,102,92,636
68,4/16/2012,1,0,15446,1,61,0.503532723,0.496467292,1,61,1049,50,124,61,697
69,4/17/2012,0,1,15447,0,-79,0.237972602,0.762027413,-1,79,1128,257,21,79,776
70,4/18/2012,1,0,15448,1,-41,0.563803196,0.436196789,1,-41,1087,87,58,-41,735
71,4/19/2012,1,0,15449,1,313,0.566626698,0.433373317,1,313,1400,4,321,313,1048
72,4/20/2012,0,1,15450,0,107,0.293147296,0.706852734,-1,-107,1293,13,202,-200,848
73,4/23/2012,1,0,15453,1,-427,0.612625659,0.387374341,1,-427,866,452,0,-200,648
74,4/24/2012,1,0,15454,1,38,0.759618551,0.240381435,1,38,904,77,196,38,686
75,4/25/2012,1,0,15455,1,-23,0.577671736,0.422328293,1,-23,881,170,37,-23,663
76,4/26/2012,0,1,15456,0,88,0.322383061,0.677616954,-1,-88,793,130,91,-88,575
77,4/27/2012,1,0,15457,1,-70,0.719452381,0.280547604,1,-70,723,81,42,-70,505
78,4/30/2012,1,0,15460,1,280,0.630520731,0.369479239,1,280,1003,5,324,280,785
79,5/2/2012,1,0,15462,1,105,0.639688671,0.360311314,1,105,1108,40,166,105,890
80,5/3/2012,1,0,15463,1,-77,0.730988473,0.269011512,1,-77,1031,176,2,-77,813
81,5/4/2012,0,1,15464,0,-50,0.258336365,0.741663605,-1,50,1081,58,87,50,863
82,5/7/2012,1,0,15467,1,-234,0.595598012,0.404401943,1,-234,847,261,0,-200,663
83,5/8/2012,1,0,15468,1,-189,0.719808996,0.280191034,1,-189,658,261,20,-200,463
84,5/9/2012,1,0,15469,1,-34,0.548081696,0.451918274,1,-34,624,113,35,-34,429
85,5/10/2012,1,0,15470,1,-217,0.711383969,0.288616031,1,-217,407,258,38,-200,229
86,5/11/2012,0,1,15471,0,-106,0.484043509,0.515956491,-1,106,513,158,43,106,335
87,5/14/2012,1,0,15474,1,-309,0.756429166,0.243570797,1,-309,204,343,26,-200,135
88,5/15/2012,1,0,15475,1,204,0.76945442,0.23054558,1,204,408,10,297,204,339
89,5/16/2012,1,0,15476,1,-288,0.645004421,0.354995593,1,-288,120,447,17,-200,139
90,5/17/2012,0,1,15477,0,-195,0.409378782,0.590621203,-1,195,315,229,96,195,334
91,5/18/2012,1,0,15478,1,157,0.510373056,0.489626944,1,157,472,208,194,-200,134
92,5/21/2012,1,0,15481,1,76,0.732673556,0.2673264,1,76,548,43,140,76,210
93,5/22/2012,1,0,15482,1,-42,0.800822854,0.199177183,1,-42,506,49,169,-42,168
94,5/23/2012,0,1,15483,0,-36,0.29627499,0.70372501,-1,36,542,107,117,36,204
95,5/24/2012,1,0,15484,1,-108,0.792902827,0.20709718,1,-108,434,131,131,-108,96
96,5/25/2012,0,1,15485,0,-27,0.422664389,0.577335626,-1,27,461,112,127,27,123
97,5/28/2012,1,0,15488,1,57,0.734540343,0.265459687,1,57,518,91,160,57,180
98,5/29/2012,1,0,15489,1,349,0.718460709,0.281539291,1,349,867,8,383,349,529
99,5/30/2012,0,1,15490,0,-102,0.423786387,0.576213628,-1,102,969,163,4,102,631
100,5/31/2012,1,0,15491,1,384,0.753374696,0.246625334,1,384,1353,26,388,384,1015
101,6/1/2012,1,0,15492,1,220,0.652068734,0.347931281,1,220,1573,0,328,220,1235
102,6/4/2012,1,0,15495,1,-86,0.807792723,0.192207247,1,-86,1487,174,34,-86,1149
103,6/5/2012,1,0,15496,1,41,0.736269534,0.263730466,1,41,1528,54,142,41,1190
104,6/6/2012,1,0,15497,1,199,0.686388671,0.313611329,1,199,1727,76,200,199,1389
105,6/7/2012,0,1,15498,0,-228,0.395945519,0.604054481,-1,228,1955,243,6,228,1617
106,6/8/2012,0,1,15499,0,-97,0.365565225,0.63443476,-1,97,2052,143,148,97,1714
107,6/11/2012,1,0,15502,1,15,0.657134861,0.342865139,1,15,2067,184,22,15,1729
108,6/12/2012,0,1,15503,0,69,0.340598255,0.659401745,-1,-69,1998,73,170,-69,1660
109,6/13/2012,0,1,15504,0,117,0.359855711,0.640144289,-1,-117,1881,118,144,-117,1543
110,6/14/2012,1,0,15505,1,-90,0.718739271,0.281260729,1,-90,1791,109,87,-90,1453
111,6/15/2012,0,1,15506,0,449,0.333652496,0.666347504,-1,-449,1342,38,453,-200,1253
112,6/18/2012,1,0,15509,1,-106,0.766902864,0.233097151,1,-106,1236,154,59,-106,1147
113,6/19/2012,1,0,15510,1,-125,0.761113763,0.238886267,1,-125,1111,154,5,-125,1022
114,6/20/2012,1,0,15511,1,49,0.652075112,0.347924918,1,49,1160,63,71,49,1071
115,6/21/2012,1,0,15512,1,-277,0.513109326,0.486890674,1,-277,883,299,9,-200,871
116,6/22/2012,0,1,15513,0,27,0.254448786,0.745551258,-1,-27,856,44,102,-27,844
117,6/25/2012,0,1,15516,0,19,0.270166114,0.729833871,-1,-19,837,112,142,-19,825
118,6/26/2012,1,0,15517,1,179,0.633097589,0.366902411,1,179,1016,15,196,179,1004
119,6/27/2012,1,0,15518,1,211,0.522847056,0.477152988,1,211,1227,39,281,211,1215
120,6/28/2012,0,1,15519,0,-118,0.483167127,0.516832829,-1,118,1345,134,39,118,1333
121,6/29/2012,1,0,15520,1,430,0.644650549,0.355349466,1,430,1775,20,527,430,1763
122,7/3/2012,1,0,15524,1,101,0.738537043,0.261462942,1,101,1876,37,128,101,1864
123,7/4/2012,0,1,15525,0,-43,0.39764075,0.602359235,-1,43,1919,112,53,43,1907
124,7/5/2012,0,1,15526,0,107,0.393941492,0.606058478,-1,-107,1812,167,125,-107,1800
125,7/6/2012,1,0,15527,1,24,0.689375699,0.310624287,1,24,1836,99,59,24,1824
126,7/9/2012,0,1,15530,0,-211,0.433993831,0.566006154,-1,211,2047,234,114,211,2035
127,7/10/2012,1,0,15531,1,-55,0.542726427,0.457273528,1,-55,1992,131,55,-55,1980
128,7/11/2012,0,1,15532,0,95,0.31286329,0.68713668,-1,-95,1897,62,163,-95,1885
129,7/12/2012,0,1,15533,0,-307,0.399935052,0.600064963,-1,307,2204,357,50,307,2192
130,7/13/2012,1,0,15534,1,6,0.728695303,0.271304712,1,6,2210,15,152,6,2198
131,7/16/2012,0,1,15537,0,-136,0.426197246,0.573802769,-1,136,2346,190,7,136,2334
132,7/17/2012,1,0,15538,1,384,0.616303653,0.383696362,1,384,2730,4,401,384,2718
133,7/18/2012,0,1,15539,0,-217,0.324709117,0.675290883,-1,217,2947,316,17,217,2935
134,7/19/2012,0,1,15540,0,156,0.418731079,0.581268966,-1,-156,2791,40,210,-200,2735
135,7/20/2012,1,0,15541,1,164,0.627459705,0.37254031,1,164,2955,14,169,164,2899
136,7/23/2012,1,0,15544,1,-281,0.655081809,0.344918177,1,-281,2674,314,9,-200,2699
137,7/24/2012,1,0,15545,1,-126,0.775400192,0.224599838,1,-126,2548,160,128,-126,2573
138,7/25/2012,0,1,15546,0,148,0.36917901,0.630821019,-1,-148,2400,53,225,-200,2373
139,7/26/2012,0,1,15547,0,-11,0.235345408,0.764654547,-1,11,2411,70,104,11,2384
140,7/27/2012,0,1,15548,0,80,0.333533958,0.666466027,-1,-80,2331,43,178,-80,2304
141,7/30/2012,1,0,15551,1,48,0.555244476,0.444755509,1,48,2379,44,80,48,2352
142,7/31/2012,1,0,15552,1,176,0.528857768,0.471142203,1,176,2555,18,282,176,2528
143,8/1/2012,0,1,15553,0,192,0.251064174,0.748935819,-1,-192,2363,7,280,-200,2328
144,8/2/2012,0,1,15554,0,-154,0.340805262,0.659194738,-1,154,2517,173,5,154,2482
145,8/3/2012,1,0,15555,1,205,0.65436691,0.345633119,1,205,2722,69,214,205,2687
146,8/6/2012,0,1,15558,0,-55,0.294461608,0.705538422,-1,55,2777,71,73,55,2742
147,8/7/2012,1,0,15559,1,13,0.605489045,0.39451094,1,13,2790,48,90,13,2755
148,8/8/2012,0,1,15560,0,-80,0.237734191,0.762265801,-1,80,2870,185,67,80,2835
149,8/9/2012,0,1,15561,0,58,0.31381458,0.686185449,-1,-58,2812,31,145,-58,2777
150,8/10/2012,0,1,15562,0,-15,0.237154447,0.762845606,-1,15,2827,155,29,15,2792
151,8/13/2012,0,1,15565,0,-152,0.433447823,0.566552162,-1,152,2979,188,8,152,2944
152,8/14/2012,0,1,15566,0,91,0.251325577,0.748674393,-1,-91,2888,80,151,-91,2853
153,8/15/2012,0,1,15567,0,-43,0.203538373,0.796461672,-1,43,2931,119,24,43,2896
154,8/16/2012,0,1,15568,0,-225,0.230958283,0.769041777,-1,225,3156,245,30,225,3121
155,8/17/2012,0,1,15569,0,84,0.243107378,0.756892622,-1,-84,3072,12,142,-84,3037
156,8/20/2012,0,1,15572,0,-14,0.36887981,0.631120175,-1,14,3086,217,35,14,3051
157,8/21/2012,0,1,15573,0,-2,0.459401831,0.540598214,-1,2,3088,187,33,2,3053
158,8/22/2012,0,1,15574,0,-142,0.247015893,0.752984136,-1,142,3230,161,15,142,3195
159,8/23/2012,1,0,15575,1,142,0.75335899,0.246641025,1,142,3372,43,167,142,3337
160,8/24/2012,0,1,15576,0,-74,0.453937694,0.546062291,-1,74,3446,129,0,74,3411
161,8/27/2012,0,1,15579,0,-167,0.301499233,0.698500782,-1,167,3613,252,10,167,3578
162,8/28/2012,0,1,15580,0,65,0.407813549,0.592186451,-1,-65,3548,8,119,-65,3513
163,8/29/2012,1,0,15581,1,-90,0.626409739,0.373590276,1,-90,3458,97,6,-90,3423
164,8/30/2012,0,1,15582,0,-92,0.216312096,0.783687919,-1,92,3550,230,0,92,3515
165,8/31/2012,0,1,15583,0,-28,0.459184602,0.540815383,-1,28,3578,76,64,28,3543
166,9/3/2012,1,0,15586,1,134,0.549503267,0.450496748,1,134,3712,54,247,134,3677
167,9/4/2012,0,1,15587,0,-91,0.430183068,0.569816947,-1,91,3803,107,64,91,3768
168,9/5/2012,0,1,15588,0,-157,0.428833365,0.571166664,-1,157,3960,208,46,157,3925
169,9/6/2012,0,1,15589,0,66,0.455387443,0.544612527,-1,-66,3894,62,103,-66,3859
170,9/7/2012,0,1,15590,0,369,0.445025057,0.554974943,-1,-369,3525,76,381,-200,3659
171,9/10/2012,1,0,15593,1,-93,0.769810468,0.230189547,1,-93,3432,134,34,-93,3566
172,9/11/2012,0,1,15594,0,71,0.239185579,0.760814428,-1,-71,3361,119,141,-71,3495
173,9/12/2012,0,1,15595,0,-1,0.471721053,0.528278947,-1,1,3362,40,86,1,3496
174,9/13/2012,0,1,15596,0,-15,0.206343256,0.793656766,-1,15,3377,17,122,15,3511
175,9/14/2012,1,0,15597,1,146,0.786351591,0.213648379,1,146,3523,19,179,146,3657
176,9/17/2012,1,0,15600,1,29,0.603747129,0.396252871,1,29,3552,53,65,29,3686
177,9/18/2012,0,1,15601,0,-51,0.191880882,0.808119118,-1,51,3603,79,66,51,3737
178,9/19/2012,0,1,15602,0,232,0.292963058,0.707036912,-1,-232,3371,0,284,-200,3537
179,9/20/2012,0,1,15603,0,-195,0.283362687,0.716637313,-1,195,3566,241,44,195,3732
180,9/21/2012,0,1,15604,0,-25,0.280305088,0.719694912,-1,25,3591,40,111,25,3757
181,9/24/2012,0,1,15607,0,124,0.260684237,0.739315748,-1,-124,3467,106,200,-200,3557
182,9/25/2012,0,1,15608,0,-24,0.355064914,0.644935101,-1,24,3491,84,37,24,3581
183,9/26/2012,0,1,15609,0,20,0.291506827,0.708493173,-1,-20,3471,17,74,-20,3561
184,9/27/2012,0,1,15610,0,258,0.473928764,0.526071221,-1,-258,3213,5,294,-200,3361
185,9/28/2012,1,0,15611,1,89,0.543091893,0.456908107,1,89,3302,105,101,89,3450
186,10/3/2012,0,1,15616,0,25,0.459919676,0.540080309,-1,-25,3277,90,165,-25,3425
187,10/4/2012,0,1,15617,0,0,0.208688676,0.791311324,-1,0,3277,63,59,0,3425
188,10/5/2012,0,1,15618,0,51,0.427511454,0.572488487,-1,-51,3226,39,108,-51,3374
189,10/8/2012,0,1,15621,0,-194,0.212691389,0.787308604,-1,194,3420,209,18,194,3568
190,10/9/2012,0,1,15622,0,45,0.376899362,0.623100579,-1,-45,3375,21,199,-45,3523
191,10/10/2012,0,1,15623,0,155,0.306301326,0.693698704,-1,-155,3220,54,165,-155,3368
192,10/11/2012,0,1,15624,0,234,0.323010832,0.676989198,-1,-234,2986,5,265,-200,3168
193,10/12/2012,0,1,15625,0,149,0.471182093,0.528817892,-1,-149,2837,14,277,-200,2968
194,10/15/2012,0,1,15628,0,10,0.361845776,0.638154238,-1,-10,2827,57,64,-10,2958
195,10/16/2012,1,0,15629,1,13,0.559638411,0.440361559,1,13,2840,93,107,13,2971
196,10/17/2012,0,1,15630,0,1,0.211204305,0.78879571,-1,-1,2839,60,39,-1,2970
197,10/18/2012,0,1,15631,0,52,0.292612597,0.707387388,-1,-52,2787,37,100,-52,2918
198,10/19/2012,0,1,15632,0,48,0.404172108,0.595827907,-1,-48,2739,20,55,-48,2870
199,10/22/2012,0,1,15635,0,281,0.45933722,0.540662766,-1,-281,2458,43,289,-200,2670
200,10/24/2012,1,0,15637,1,215,0.501622245,0.4983778,1,215,2673,25,286,215,2885
201,10/25/2012,0,1,15638,0,83,0.221112184,0.778887808,-1,-83,2590,22,91,-83,2802
202,10/26/2012,0,1,15639,0,-275,0.183518462,0.816481531,-1,275,2865,289,41,275,3077
203,10/29/2012,0,1,15642,0,16,0.317830145,0.682169884,-1,-16,2849,84,76,-16,3061
204,10/30/2012,1,0,15643,1,-90,0.522303402,0.477696553,1,-90,2759,112,98,-90,2971
205,10/31/2012,0,1,15644,0,125,0.353173107,0.646826923,-1,-125,2634,48,136,-125,2846
206,11/1/2012,0,1,15645,0,269,0.308896333,0.691103697,-1,-269,2365,113,283,-200,2646
207,11/2/2012,0,1,15646,0,74,0.27037175,0.729628235,-1,-74,2291,26,131,-74,2572
208,11/5/2012,0,1,15649,0,-27,0.22834447,0.7716555,-1,27,2318,65,93,27,2599
209,11/6/2012,0,1,15650,0,-39,0.427209556,0.572790444,-1,39,2357,136,48,39,2638
210,11/7/2012,0,1,15651,0,124,0.357907221,0.642092794,-1,-124,2233,185,147,-124,2514
211,11/8/2012,1,0,15652,1,-240,0.5462116,0.453788385,1,-240,1993,265,81,-200,2314
212,11/9/2012,1,0,15653,1,-156,0.56967482,0.430325195,1,-156,1837,175,29,-156,2158
213,11/12/2012,0,1,15656,0,74,0.324352741,0.675647259,-1,-74,1763,14,130,-74,2084
214,11/13/2012,0,1,15657,0,-176,0.460019633,0.539980382,-1,176,1939,210,33,176,2260
215,11/14/2012,1,0,15658,1,166,0.546960473,0.453039557,1,166,2105,49,189,166,2426
216,11/15/2012,0,1,15659,0,-20,0.236059897,0.763940066,-1,20,2125,99,110,20,2446
217,11/16/2012,0,1,15660,0,-71,0.411656544,0.588343471,-1,71,2196,119,25,71,2517
218,11/19/2012,0,1,15663,0,40,0.401422709,0.598577291,-1,-40,2156,73,122,-40,2477
219,11/20/2012,0,1,15664,0,-200,0.232847504,0.767152488,-1,200,2356,258,22,200,2677
220,11/21/2012,0,1,15665,0,169,0.353539824,0.646460176,-1,-169,2187,147,203,-200,2477
221,11/22/2012,0,1,15666,0,107,0.279875785,0.720124245,-1,-107,2080,95,172,-107,2370
222,11/23/2012,0,1,15667,0,140,0.347294778,0.652705222,-1,-140,1940,47,170,-140,2230
223,11/26/2012,0,1,15670,0,-131,0.274689928,0.725310087,-1,131,2071,176,44,131,2361
224,11/27/2012,0,1,15671,0,-177,0.451653436,0.548346579,-1,177,2248,189,38,177,2538
225,11/28/2012,0,1,15672,0,-29,0.243238077,0.756761938,-1,29,2277,127,18,29,2567
226,11/29/2012,1,0,15673,1,3,0.508204758,0.491795242,1,3,2280,95,52,3,2570
227,11/30/2012,1,0,15674,1,43,0.534921139,0.465078861,1,43,2323,48,160,43,2613
228,12/3/2012,0,1,15677,0,-355,0.327712104,0.672287911,-1,355,2678,373,132,355,2968
229,12/4/2012,0,1,15678,0,74,0.438728437,0.561271578,-1,-74,2604,8,184,-74,2894
230,12/5/2012,0,1,15679,0,492,0.378745452,0.621254504,-1,-492,2112,56,497,-200,2694
231,12/6/2012,0,1,15680,0,-54,0.401589781,0.598410219,-1,54,2166,74,86,54,2748
232,12/7/2012,1,0,15681,1,-61,0.516506344,0.483493611,1,-61,2105,103,83,-61,2687
233,12/10/2012,1,0,15684,1,-128,0.500437692,0.499562308,1,-128,1977,157,35,-128,2559
234,12/11/2012,1,0,15685,1,-34,0.598218918,0.401781082,1,-34,1943,90,97,-34,2525
235,12/12/2012,0,1,15686,0,129,0.309356526,0.69064343,-1,-129,1814,7,147,-129,2396
236,12/13/2012,0,1,15687,0,-62,0.250482053,0.749517947,-1,62,1876,111,71,62,2458
237,12/14/2012,0,1,15688,0,233,0.281148732,0.718851298,-1,-233,1643,14,272,-200,2258
238,12/17/2012,1,0,15691,1,-110,0.582439572,0.417560428,1,-110,1533,152,31,-110,2148
239,12/18/2012,0,1,15692,0,-87,0.299463049,0.700536907,-1,87,1620,131,31,87,2235
240,12/19/2012,0,1,15693,0,-20,0.369017079,0.630982906,-1,20,1640,83,73,20,2255
241,12/20/2012,0,1,15694,0,78,0.298725218,0.701274753,-1,-78,1562,74,115,-78,2177
242,12/21/2012,0,1,15695,0,-138,0.370230824,0.629769176,-1,138,1700,190,16,138,2315
243,12/24/2012,1,0,15698,1,96,0.783601433,0.216398589,1,96,1796,20,125,96,2411
244,12/27/2012,0,1,15701,0,-24,0.378079742,0.621920288,-1,24,1820,61,110,24,2435
245,12/28/2012,1,0,15702,1,-48,0.585215747,0.414784297,1,-48,1772,57,19,-48,2387
246,12/31/2012,0,1,15705,0,151,0.439896315,0.560103655,-1,-151,1621,23,218,-200,2187
0,1/2/2013,0,1,15707,0,374,0.48004736,0.519952595,-1,-374,-374,0,470,-200,-200
1,1/3/2013,0,1,15708,0,91,0.234878398,0.765121609,-1,-91,-465,104,92,-91,-291
2,1/4/2013,0,1,15709,0,-63,0.270726174,0.729273856,-1,63,-402,163,12,63,-228
3,1/7/2013,1,0,15712,1,7,0.550027877,0.449972138,1,7,-395,69,63,7,-221
4,1/8/2013,1,0,15713,1,-177,0.636318773,0.363681227,1,-177,-572,227,0,-200,-421
5,1/9/2013,1,0,15714,1,21,0.612075597,0.387924403,1,21,-551,41,56,21,-400
6,1/10/2013,0,1,15715,0,51,0.424396202,0.575603783,-1,-51,-602,132,226,-200,-600
7,1/11/2013,0,1,15716,0,-194,0.363197088,0.636802882,-1,194,-408,260,0,194,-406
8,1/14/2013,1,0,15719,1,78,0.506970853,0.493029177,1,78,-330,27,163,78,-328
9,1/15/2013,0,1,15720,0,11,0.332291082,0.667708904,-1,-11,-341,62,193,-11,-339
10,1/16/2013,0,1,15721,0,-50,0.410293341,0.58970663,-1,50,-291,225,0,50,-289
11,1/17/2013,0,1,15722,0,-22,0.465375841,0.534624159,-1,22,-269,161,157,22,-267
12,1/18/2013,0,1,15723,0,58,0.381711125,0.618288875,-1,-58,-327,63,93,-58,-325
13,1/21/2013,0,1,15726,0,81,0.316440269,0.683559746,-1,-81,-408,25,134,-81,-406
14,1/22/2013,0,1,15727,0,34,0.429948777,0.570051253,-1,-34,-442,141,59,-34,-440
15,1/23/2013,1,0,15728,1,-63,0.630177587,0.369822383,1,-63,-505,161,39,-63,-503
16,1/24/2013,0,1,15729,0,79,0.325384989,0.674615026,-1,-79,-584,16,172,-79,-582
17,1/25/2013,0,1,15730,0,-63,0.257412203,0.742587775,-1,63,-521,148,35,63,-519
18,1/28/2013,0,1,15733,0,40,0.295842737,0.704157263,-1,-40,-561,0,132,-40,-559
19,1/29/2013,0,1,15734,0,45,0.296369493,0.703630507,-1,-45,-606,40,93,-45,-604
20,1/30/2013,0,1,15735,0,74,0.3085237,0.691476256,-1,-74,-680,32,174,-74,-678
21,1/31/2013,0,1,15736,0,-6,0.451360628,0.548639417,-1,6,-674,79,34,6,-672
22,2/1/2013,0,1,15737,0,-4,0.448800057,0.551199913,-1,4,-670,192,23,4,-668
23,2/4/2013,0,1,15740,0,-246,0.377924874,0.622075111,-1,246,-424,264,101,246,-422
24,2/5/2013,0,1,15741,0,-285,0.447712362,0.552287638,-1,285,-139,289,78,285,-137
25,2/6/2013,0,1,15742,0,-5,0.317224607,0.682775408,-1,5,-134,50,132,5,-132
26,2/7/2013,0,1,15743,0,-98,0.375489786,0.624510229,-1,98,-36,139,5,98,-34
27,2/8/2013,0,1,15744,0,79,0.289622337,0.710377663,-1,-79,-115,47,137,-79,-113
28,2/14/2013,0,1,15750,0,-31,0.336153924,0.663846076,-1,31,-84,145,39,31,-82
29,2/15/2013,0,1,15751,0,56,0.441711292,0.558288783,-1,-56,-140,102,85,-56,-138
30,2/18/2013,0,1,15754,0,-135,0.372720823,0.627279162,-1,135,-5,168,12,135,-3
31,2/19/2013,0,1,15755,0,-220,0.437187821,0.56281215,-1,220,215,257,67,220,217
32,2/20/2013,0,1,15756,0,-65,0.418885082,0.581114888,-1,65,280,152,19,65,282
33,2/21/2013,0,1,15757,0,-212,0.259365141,0.740634888,-1,212,492,270,0,212,494
34,2/22/2013,0,1,15758,0,-27,0.379840791,0.620159209,-1,27,519,145,59,27,521
35,2/25/2013,0,1,15761,0,104,0.363044351,0.636955649,-1,-104,415,0,105,-104,417
36,2/26/2013,0,1,15762,0,-20,0.482805118,0.517194897,-1,20,435,73,177,20,437
37,2/27/2013,0,1,15763,0,-11,0.333895087,0.666104943,-1,11,446,46,78,11,448
38,2/28/2013,1,0,15764,1,216,0.517205179,0.482794836,1,216,662,116,245,216,664
39,3/1/2013,0,1,15765,0,-56,0.374685779,0.625314206,-1,56,718,99,14,56,720
40,3/4/2013,1,0,15768,1,-350,0.523158729,0.476841271,1,-350,368,450,65,-200,520
41,3/5/2013,0,1,15769,0,-121,0.342958003,0.657041997,-1,121,489,125,54,121,641
42,3/6/2013,0,1,15770,0,-14,0.372907311,0.627092719,-1,14,503,92,79,14,655
43,3/7/2013,0,1,15771,0,90,0.386153132,0.613846868,-1,-90,413,62,167,-90,565
44,3/8/2013,0,1,15772,0,364,0.364109591,0.635890424,-1,-364,49,33,455,-200,365
45,3/11/2013,0,1,15775,0,-52,0.270727009,0.729272991,-1,52,101,99,110,52,417
46,3/12/2013,1,0,15776,1,-290,0.56286484,0.43713519,1,-290,-189,291,159,-200,217
47,3/13/2013,0,1,15777,0,-412,0.484354481,0.515645534,-1,412,223,456,20,412,629
48,3/14/2013,0,1,15778,0,136,0.296518728,0.703481287,-1,-136,87,155,223,-200,429
49,3/15/2013,0,1,15779,0,-299,0.453453511,0.546546489,-1,299,386,346,84,299,728
50,3/18/2013,1,0,15782,1,-83,0.526388764,0.473611221,1,-83,303,208,16,-200,528
51,3/19/2013,1,0,15783,1,-172,0.650715113,0.349284872,1,-172,131,196,35,-172,356
52,3/20/2013,0,1,15784,0,318,0.419151559,0.580848455,-1,-318,-187,10,392,-200,156
53,3/21/2013,0,1,15785,0,61,0.346858561,0.653141439,-1,-61,-248,41,191,-61,95
54,3/22/2013,0,1,15786,0,-2,0.40704976,0.592950225,-1,2,-246,101,118,2,97
55,3/25/2013,1,0,15789,1,-115,0.538172781,0.461827219,1,-115,-361,172,20,-115,-18
56,3/26/2013,0,1,15790,0,114,0.385640234,0.614359766,-1,-114,-475,79,211,-200,-218
57,3/27/2013,0,1,15791,0,103,0.464788839,0.535211146,-1,-103,-578,18,163,-103,-321
58,3/28/2013,1,0,15792,1,-96,0.673751295,0.326248676,1,-96,-674,287,0,-200,-521
59,4/2/2013,1,0,15797,1,289,0.51944077,0.480559185,1,289,-385,3,372,289,-232
60,4/3/2013,0,1,15798,0,-129,0.291339442,0.708660603,-1,129,-256,195,39,129,-103
61,4/5/2013,0,1,15800,0,-585,0.407076582,0.592923403,-1,585,329,601,4,585,482
62,4/8/2013,1,0,15803,1,-13,0.751017928,0.248982057,1,-13,316,65,110,-13,469
63,4/9/2013,0,1,15804,0,104,0.441100508,0.558899492,-1,-104,212,25,233,-200,269
64,4/10/2013,1,0,15805,1,114,0.598517239,0.401482716,1,114,326,25,166,114,383
65,4/11/2013,0,1,15806,0,-11,0.308579743,0.691420257,-1,11,337,129,104,11,394
66,4/12/2013,1,0,15807,1,-53,0.713309795,0.286690176,1,-53,284,133,43,-53,341
67,4/15/2013,0,1,15810,0,-248,0.444048733,0.555951238,-1,248,532,318,43,248,589
68,4/16/2013,0,1,15811,0,156,0.279406607,0.720593393,-1,-156,376,57,314,-200,389
69,4/17/2013,0,1,15812,0,-230,0.293309197,0.706690818,-1,230,606,236,38,230,619
70,4/18/2013,0,1,15813,0,148,0.281588122,0.718411893,-1,-148,458,71,236,-200,419
71,4/19/2013,0,1,15814,0,549,0.326173916,0.673826098,-1,-549,-91,0,583,-200,219
72,4/22/2013,1,0,15817,1,71,0.624871761,0.37512821,1,71,-20,10,202,71,290
73,4/23/2013,0,1,15818,0,-246,0.489819258,0.510180771,-1,246,226,319,66,246,536
74,4/24/2013,0,1,15819,0,55,0.473331451,0.526668578,-1,-55,171,136,122,-55,481
75,4/25/2013,0,1,15820,0,283,0.322372898,0.677627087,-1,-283,-112,1,371,-200,281
76,4/26/2013,1,0,15821,1,80,0.530317456,0.469682544,1,80,-32,0,236,80,361
77,4/29/2013,0,1,15824,0,-41,0.431468919,0.568531126,-1,41,9,97,50,41,402
78,4/30/2013,0,1,15825,0,-17,0.463007063,0.536992937,-1,17,26,58,154,17,419
79,5/2/2013,0,1,15827,0,20,0.278233111,0.721766889,-1,-20,6,157,30,-20,399
80,5/3/2013,0,1,15828,0,-162,0.456188649,0.543811351,-1,162,168,164,84,162,561
81,5/6/2013,0,1,15831,0,-127,0.2363033,0.76369673,-1,127,295,166,21,127,688
82,5/7/2013,0,1,15832,0,117,0.481346935,0.518653035,-1,-117,178,60,150,-117,571
83,5/8/2013,0,1,15833,0,-45,0.335211575,0.664788425,-1,45,223,61,73,45,616
84,5/9/2013,0,1,15834,0,-44,0.280494332,0.719505668,-1,44,267,132,57,44,660
85,5/10/2013,0,1,15835,0,83,0.448296055,0.55170393,-1,-83,184,78,107,-83,577
86,5/13/2013,0,1,15838,0,-256,0.259155989,0.740844011,-1,256,440,306,39,256,833
87,5/14/2013,0,1,15839,0,-105,0.314607859,0.685392141,-1,105,545,176,125,105,938
88,5/15/2013,0,1,15840,0,-68,0.281415641,0.718584388,-1,68,613,101,79,68,1006
89,5/16/2013,0,1,15841,0,-54,0.319491461,0.680508524,-1,54,667,204,51,54,1060
90,5/20/2013,0,1,15845,0,202,0.226115793,0.773884237,-1,-202,465,11,267,-200,860
91,5/21/2013,0,1,15846,0,-38,0.348328412,0.651671559,-1,38,503,76,38,38,898
92,5/22/2013,0,1,15847,0,-141,0.434351221,0.565648764,-1,141,644,260,5,141,1039
93,5/23/2013,0,1,15848,0,-529,0.225320376,0.774679601,-1,529,1173,538,43,529,1568
94,5/24/2013,1,0,15849,1,-86,0.742497772,0.257502183,1,-86,1087,263,77,-200,1368
95,5/27/2013,1,0,15852,1,227,0.685117066,0.314882994,1,227,1314,0,299,227,1595
96,5/28/2013,1,0,15853,1,148,0.548490077,0.451509923,1,148,1462,124,205,148,1743
97,5/29/2013,0,1,15854,0,-302,0.236902341,0.763097674,-1,302,1764,339,25,302,2045
98,5/30/2013,0,1,15855,0,-10,0.382192537,0.617807478,-1,10,1774,84,157,10,2055
99,5/31/2013,1,0,15856,1,-124,0.631028026,0.368971974,1,-124,1650,239,21,-200,1855
100,6/3/2013,1,0,15859,1,3,0.61732167,0.38267833,1,3,1653,29,349,3,1858
101,6/4/2013,1,0,15860,1,-51,0.71727255,0.28272748,1,-51,1602,133,68,-51,1807
102,6/5/2013,0,1,15861,0,-94,0.339746192,0.660253763,-1,94,1696,254,19,94,1901
103,6/6/2013,1,0,15862,1,-125,0.601556271,0.398443714,1,-125,1571,163,47,-125,1776
104,6/7/2013,1,0,15863,1,-217,0.757441223,0.242558755,1,-217,1354,280,58,-200,1576
105,6/10/2013,0,1,15866,0,-26,0.461878672,0.538121313,-1,26,1380,117,112,26,1602
106,6/11/2013,0,1,15867,0,-170,0.230008639,0.769991368,-1,170,1550,225,111,170,1772
107,6/13/2013,0,1,15869,0,-130,0.305308208,0.694691777,-1,130,1680,399,0,130,1902
108,6/14/2013,1,0,15870,1,-107,0.781683832,0.218316168,1,-107,1573,162,78,-107,1795
109,6/17/2013,1,0,15873,1,254,0.693996459,0.306003511,1,254,1827,4,398,254,2049
110,6/18/2013,0,1,15874,0,100,0.275035068,0.724964887,-1,-100,1727,124,128,-100,1949
111,6/19/2013,1,0,15875,1,-252,0.544247329,0.455752671,1,-252,1475,354,10,-200,1749
112,6/20/2013,0,1,15876,0,-482,0.234803833,0.765196174,-1,482,1957,499,0,482,2231
113,6/21/2013,0,1,15877,0,311,0.266684517,0.733315498,-1,-311,1646,16,448,-200,2031
114,6/24/2013,0,1,15880,0,-92,0.241471834,0.758528173,-1,92,1738,184,184,92,2123
115,6/25/2013,1,0,15881,1,27,0.500293419,0.499706551,1,27,1765,403,183,-200,1923
116,6/26/2013,1,0,15882,1,364,0.703275889,0.296724066,1,364,2129,72,433,364,2287
117,6/27/2013,1,0,15883,1,181,0.741828918,0.258171096,1,181,2310,11,320,181,2468
118,6/28/2013,1,0,15884,1,141,0.762077481,0.23792249,1,141,2451,136,218,141,2609
119,7/2/2013,1,0,15888,1,-101,0.589149058,0.410850868,1,-101,2350,150,289,-101,2508
120,7/3/2013,0,1,15889,0,-381,0.3791897,0.6208103,-1,381,2731,469,17,381,2889
121,7/4/2013,0,1,15890,0,63,0.417200774,0.582799256,-1,-63,2668,78,186,-63,2826
122,7/5/2013,1,0,15891,1,179,0.528356463,0.471643493,1,179,2847,18,246,179,3005
123,7/8/2013,0,1,15894,0,-148,0.203666344,0.796333641,-1,148,2995,480,60,148,3153
124,7/9/2013,1,0,15895,1,116,0.63432461,0.365675434,1,116,3111,127,125,116,3269
125,7/10/2013,0,1,15896,0,81,0.245441593,0.754558444,-1,-81,3030,198,281,-200,3069
126,7/11/2013,0,1,15897,0,312,0.340474412,0.659525603,-1,-312,2718,1,413,-200,2869
127,7/12/2013,1,0,15898,1,-308,0.6779356,0.322064385,1,-308,2410,317,11,-200,2669
128,7/15/2013,0,1,15901,0,-37,0.464689627,0.535310358,-1,37,2447,81,147,37,2706
129,7/16/2013,1,0,15902,1,45,0.67677021,0.32322976,1,45,2492,71,152,45,2751
130,7/17/2013,1,0,15903,1,38,0.535011113,0.464988887,1,38,2530,62,177,38,2789
131,7/18/2013,1,0,15904,1,-58,0.613641202,0.386358812,1,-58,2472,176,40,-58,2731
132,7/19/2013,0,1,15905,0,-65,0.398961917,0.601038098,-1,65,2537,260,21,65,2796
133,7/22/2013,1,0,15908,1,-126,0.736747593,0.263252407,1,-126,2411,263,11,-200,2596
134,7/23/2013,1,0,15909,1,378,0.693241984,0.306758031,1,378,2789,38,465,378,2974
135,7/24/2013,0,1,15910,0,106,0.296176538,0.703823447,-1,-106,2683,47,136,-106,2868
136,7/25/2013,0,1,15911,0,44,0.214409642,0.785590291,-1,-44,2639,29,110,-44,2824
137,7/26/2013,1,0,15912,1,26,0.634196132,0.365803868,1,26,2665,108,100,26,2850
138,7/29/2013,1,0,15915,1,-35,0.658439755,0.341560259,1,-35,2630,135,66,-35,2815
139,7/30/2013,0,1,15916,0,132,0.338930443,0.661069542,-1,-132,2498,0,200,-200,2615
140,7/31/2013,0,1,15917,0,-42,0.313315094,0.686684936,-1,42,2540,126,141,42,2657
141,8/1/2013,1,0,15918,1,51,0.744768739,0.255231306,1,51,2591,17,190,51,2708
142,8/2/2013,0,1,15919,0,-123,0.237571925,0.762428015,-1,123,2714,161,29,123,2831
143,8/5/2013,1,0,15922,1,-81,0.546513528,0.453486487,1,-81,2633,119,1,-81,2750
144,8/6/2013,0,1,15923,0,-124,0.40101701,0.59898299,-1,124,2757,207,88,124,2874
145,8/7/2013,0,1,15924,0,-109,0.432748049,0.567251921,-1,109,2866,138,186,109,2983
146,8/8/2013,1,0,15925,1,34,0.622467697,0.377532348,1,34,2900,24,153,34,3017
147,8/9/2013,1,0,15926,1,32,0.709462881,0.290537119,1,32,2932,53,113,32,3049
148,8/12/2013,1,0,15929,1,400,0.68734175,0.31265825,1,400,3332,129,477,400,3449
149,8/13/2013,0,1,15930,0,194,0.243512452,0.756487548,-1,-194,3138,71,196,-194,3255
150,8/15/2013,0,1,15932,0,84,0.377602771,0.622397214,-1,-84,3054,16,212,-200,3055
151,8/16/2013,0,1,15933,0,68,0.463969409,0.536030561,-1,-68,2986,154,224,-200,2855
152,8/19/2013,0,1,15936,0,59,0.231793284,0.768206745,-1,-59,2927,15,172,-59,2796
153,8/20/2013,0,1,15937,0,-440,0.24629543,0.753704548,-1,440,3367,465,145,440,3236
154,8/21/2013,1,0,15938,1,-206,0.738504618,0.261495367,1,-206,3161,383,38,-200,3036
155,8/22/2013,0,1,15939,0,417,0.339542031,0.660457939,-1,-417,2744,25,475,-200,2836
156,8/23/2013,0,1,15940,0,-146,0.315429941,0.684570104,-1,146,2890,246,99,146,2982
157,8/26/2013,1,0,15943,1,69,0.723168135,0.276831865,1,69,2959,90,177,69,3051
158,8/27/2013,1,0,15944,1,-124,0.566383779,0.433616266,1,-124,2835,201,70,-200,2851
159,8/28/2013,1,0,15945,1,-90,0.644729882,0.355270103,1,-90,2745,182,70,-90,2761
160,8/29/2013,0,1,15946,0,89,0.3737939,0.6262061,-1,-89,2656,0,166,-89,2672
161,8/30/2013,0,1,15947,0,48,0.338915616,0.661084414,-1,-48,2608,112,126,-48,2624
162,9/2/2013,0,1,15950,0,506,0.357375368,0.642624646,-1,-506,2102,0,542,-200,2424
163,9/3/2013,1,0,15951,1,120,0.506625921,0.49337405,1,120,2222,24,213,120,2544
164,9/4/2013,0,1,15952,0,192,0.232711017,0.767288983,-1,-192,2030,68,254,-200,2344
165,9/5/2013,0,1,15953,0,164,0.335769892,0.664230108,-1,-164,1866,26,254,-200,2144
166,9/6/2013,0,1,15954,0,92,0.384077266,0.615922749,-1,-92,1774,41,118,-92,2052
167,9/9/2013,0,1,15957,0,-93,0.457234561,0.542765439,-1,93,1867,167,62,93,2145
168,9/10/2013,1,0,15958,1,-14,0.661568314,0.338431701,1,-14,1853,127,35,-14,2131
169,9/11/2013,0,1,15959,0,-101,0.445865229,0.554134816,-1,101,1954,200,68,101,2232
170,9/12/2013,1,0,15960,1,-15,0.702644229,0.297355786,1,-15,1939,66,84,-15,2217
171,9/13/2013,0,1,15961,0,0,0.266956285,0.733043671,-1,0,1939,111,59,0,2217
172,9/16/2013,1,0,15964,1,87,0.605744511,0.39425543,1,87,2026,33,97,87,2304
173,9/17/2013,1,0,15965,1,-59,0.517893255,0.48210673,1,-59,1967,102,37,-59,2245
174,9/18/2013,1,0,15966,1,-95,0.706300288,0.293699697,1,-95,1872,200,4,-200,2045
175,9/19/2013,1,0,15967,1,-9,0.798592597,0.201407418,1,-9,1863,68,52,-9,2036
176,9/23/2013,0,1,15971,0,-64,0.424425364,0.575574607,-1,64,1927,131,89,64,2100
177,9/24/2013,1,0,15972,1,-99,0.713840485,0.286159486,1,-99,1828,202,63,-200,1900
178,9/25/2013,0,1,15973,0,-62,0.41985032,0.58014968,-1,62,1890,73,58,62,1962
179,9/26/2013,1,0,15974,1,13,0.563559175,0.43644084,1,13,1903,78,131,13,1975
180,9/27/2013,0,1,15975,0,-46,0.280864269,0.719135761,-1,46,1949,108,16,46,2021
181,9/30/2013,0,1,15978,0,-101,0.4065575,0.593442559,-1,101,2050,173,29,101,2122
182,10/2/2013,1,0,15980,1,26,0.620666325,0.379333675,1,26,2076,44,199,26,2148
183,10/3/2013,1,0,15981,1,87,0.731480211,0.268519849,1,87,2163,31,161,87,2235
184,10/4/2013,1,0,15982,1,76,0.53516832,0.46483168,1,76,2239,52,137,76,2311
185,10/7/2013,1,0,15985,1,-255,0.546751648,0.453248322,1,-255,1984,305,0,-200,2111
186,10/8/2013,1,0,15986,1,288,0.661991447,0.338008553,1,288,2272,15,349,288,2399
187,10/9/2013,0,1,15987,0,44,0.313363045,0.686636984,-1,-44,2228,35,77,-44,2355
188,10/10/2013,0,1,15988,0,-83,0.325760856,0.674239129,-1,83,2311,355,66,83,2438
189,10/11/2013,0,1,15989,0,-65,0.351592839,0.648407191,-1,65,2376,99,86,65,2503
190,10/15/2013,1,0,15993,1,-140,0.67231527,0.32768473,1,-140,2236,226,8,-200,2303
191,10/16/2013,0,1,15994,0,-187,0.339962885,0.6600371,-1,187,2423,317,0,187,2490
192,10/17/2013,1,0,15995,1,-390,0.710309058,0.289690912,1,-390,2033,411,29,-200,2290
193,10/18/2013,1,0,15996,1,63,0.732102215,0.267897815,1,63,2096,84,94,63,2353
194,10/21/2013,0,1,15999,0,-53,0.464541852,0.535458207,-1,53,2149,123,76,53,2406
195,10/22/2013,1,0,16000,1,-16,0.563051641,0.436948314,1,-16,2133,76,54,-16,2390
196,10/23/2013,1,0,16001,1,-460,0.634977311,0.365022719,1,-460,1673,502,80,-200,2190
197,10/24/2013,1,0,16002,1,-147,0.642756909,0.357243061,1,-147,1526,203,19,-200,1990
198,10/25/2013,1,0,16003,1,-48,0.65344587,0.34655413,1,-48,1478,100,112,-48,1942
199,10/28/2013,1,0,16006,1,31,0.65498811,0.345011845,1,31,1509,29,99,31,1973
200,10/29/2013,1,0,16007,1,147,0.670551717,0.329448283,1,147,1656,0,278,147,2120
201,10/30/2013,0,1,16008,0,79,0.450307772,0.549692243,-1,-79,1577,186,100,-79,2041
202,10/31/2013,1,0,16009,1,62,0.562393367,0.437606648,1,62,1639,69,103,62,2103
203,11/1/2013,0,1,16010,0,74,0.355270073,0.644729912,-1,-74,1565,20,175,-74,2029
204,11/4/2013,0,1,16013,0,-138,0.336008847,0.663991123,-1,138,1703,151,82,138,2167
205,11/5/2013,1,0,16014,1,-286,0.668571681,0.331428349,1,-286,1417,384,49,-200,1967
206,11/6/2013,0,1,16015,0,-15,0.443726003,0.556273997,-1,15,1432,139,68,15,1982
207,11/7/2013,1,0,16016,1,-263,0.667327255,0.332672715,1,-263,1169,278,25,-200,1782
208,11/8/2013,0,1,16017,0,65,0.478447214,0.521552801,-1,-65,1104,29,111,-65,1717
209,11/11/2013,0,1,16020,0,255,0.254138574,0.745861411,-1,-255,849,99,376,-200,1517
210,11/12/2013,1,0,16021,1,-159,0.659505337,0.340494633,1,-159,690,198,80,-159,1358
211,11/13/2013,0,1,16022,0,-264,0.395978868,0.604021162,-1,264,954,347,0,264,1622
212,11/14/2013,1,0,16023,1,-60,0.751323938,0.248676069,1,-60,894,121,48,-60,1562
213,11/15/2013,1,0,16024,1,350,0.742290854,0.257709131,1,350,1244,0,389,350,1912
214,11/18/2013,1,0,16027,1,293,0.528829902,0.471170068,1,293,1537,20,361,293,2205
215,11/19/2013,1,0,16028,1,32,0.573332846,0.426667169,1,32,1569,66,186,32,2237
216,11/20/2013,0,1,16029,0,-37,0.275935337,0.724064678,-1,37,1606,79,83,37,2274
217,11/21/2013,0,1,16030,0,-119,0.25146924,0.748530775,-1,119,1725,186,26,119,2393
218,11/22/2013,1,0,16031,1,-4,0.573285908,0.426714092,1,-4,1721,69,58,-4,2389
219,11/25/2013,1,0,16034,1,-215,0.671481997,0.328518033,1,-215,1506,258,1,-200,2189
220,11/26/2013,0,1,16035,0,39,0.367621467,0.632378489,-1,-39,1467,17,88,-39,2150
221,11/27/2013,0,1,16036,0,154,0.480472907,0.519527078,-1,-154,1313,27,210,-200,1950
222,11/28/2013,0,1,16037,0,55,0.40480122,0.59519884,-1,-55,1258,2,133,-55,1895
223,11/29/2013,0,1,16038,0,43,0.450428084,0.549571931,-1,-43,1215,49,63,-43,1852
224,12/2/2013,0,1,16041,0,105,0.433109507,0.566890508,-1,-105,1110,57,238,-200,1652
225,12/3/2013,0,1,16042,0,11,0.243602127,0.756397843,-1,-11,1099,77,118,-11,1641
226,12/4/2013,1,0,16043,1,-25,0.606517166,0.393482819,1,-25,1074,223,99,-200,1441
227,12/5/2013,0,1,16044,0,98,0.312486917,0.687513113,-1,-98,976,50,128,-98,1343
228,12/6/2013,0,1,16045,0,129,0.454254046,0.545745939,-1,-129,847,23,228,-200,1143
229,12/9/2013,0,1,16048,0,-269,0.350843355,0.64915663,-1,269,1116,274,10,269,1412
230,12/10/2013,1,0,16049,1,-33,0.633400977,0.366599053,1,-33,1083,73,49,-33,1379
231,12/11/2013,1,0,16050,1,-404,0.694169849,0.305830181,1,-404,679,491,14,-200,1179
232,12/12/2013,0,1,16051,0,-101,0.30130665,0.698693395,-1,101,780,134,55,101,1280
233,12/13/2013,0,1,16052,0,205,0.38852936,0.61147067,-1,-205,575,42,293,-200,1080
234,12/16/2013,1,0,16055,1,-11,0.64108333,0.35891667,1,-11,564,117,122,-11,1069
235,12/17/2013,1,0,16056,1,-190,0.541772902,0.458227098,1,-190,374,242,7,-200,869
236,12/18/2013,1,0,16057,1,63,0.571663618,0.428336412,1,63,437,131,123,63,932
237,12/19/2013,0,1,16058,0,-555,0.458541721,0.541458309,-1,555,992,669,27,555,1487
238,12/20/2013,0,1,16059,0,-98,0.43432723,0.565672785,-1,98,1090,238,0,98,1585
239,12/23/2013,1,0,16062,1,-43,0.544378281,0.455621704,1,-43,1047,122,29,-43,1542
240,12/24/2013,1,0,16063,1,241,0.61057508,0.38942489,1,241,1288,8,261,241,1783
241,12/27/2013,0,1,16066,0,156,0.235559233,0.764440745,-1,-156,1132,94,173,-156,1627
242,12/30/2013,1,0,16069,1,-89,0.600079596,0.399920374,1,-89,1043,100,65,-89,1538
243,12/31/2013,1,0,16070,1,-30,0.60166195,0.39833805,1,-30,1013,112,45,-30,1508
0,1/2/2014,0,1,16072,0,-80,0.421287239,0.578712791,-1,80,80,246,98,80,80
1,1/3/2014,1,0,16073,1,-382,0.536621988,0.463377953,1,-382,-302,420,0,-200,-120
2,1/6/2014,0,1,16076,0,-114,0.386838809,0.613161206,-1,114,-188,244,9,114,-6
3,1/7/2014,1,0,16077,1,0,0.608700573,0.391299412,1,0,-188,16,172,0,-6
4,1/8/2014,0,1,16078,0,210,0.461443931,0.538556039,-1,-210,-398,20,317,-200,-206
5,1/9/2014,0,1,16079,0,-118,0.299926296,0.700073689,-1,118,-280,220,120,118,-88
6,1/10/2014,1,0,16080,1,113,0.633929342,0.366070643,1,113,-167,70,211,113,25
7,1/13/2014,1,0,16083,1,-188,0.658642769,0.341357246,1,-188,-355,287,150,-200,-175
8,1/14/2014,1,0,16084,1,172,0.601630002,0.398369968,1,172,-183,36,284,172,-3
9,1/15/2014,0,1,16085,0,-26,0.464614615,0.53538537,-1,26,-157,128,92,26,23
10,1/16/2014,0,1,16086,0,-147,0.380492419,0.619507581,-1,147,-10,213,0,147,170
11,1/17/2014,0,1,16087,0,244,0.452586457,0.547413558,-1,-244,-254,84,369,-200,-30
12,1/20/2014,0,1,16090,0,-192,0.45665291,0.54334709,-1,192,-62,204,48,192,162
13,1/21/2014,1,0,16091,1,45,0.502879411,0.497120589,1,45,-17,20,182,45,207
14,1/22/2014,0,1,16092,0,56,0.411058396,0.588941634,-1,-56,-73,88,140,-56,151
15,1/23/2014,1,0,16093,1,-399,0.640610397,0.359389558,1,-399,-472,430,28,-200,-49
16,1/24/2014,0,1,16094,0,-150,0.394737452,0.605262548,-1,150,-322,164,57,150,101
17,1/27/2014,1,0,16097,1,-108,0.545275271,0.454724669,1,-108,-430,180,8,-108,-7
18,1/28/2014,1,0,16098,1,64,0.593111426,0.406888574,1,64,-366,64,66,64,57
19,1/29/2014,0,1,16099,0,81,0.475302026,0.524697989,-1,-81,-447,45,148,-81,-24
20,1/30/2014,1,0,16100,1,236,0.590359032,0.409640953,1,236,-211,68,239,236,212
21,2/4/2014,1,0,16105,1,-28,0.689100862,0.310899153,1,-28,-239,133,120,-28,184
22,2/5/2014,1,0,16106,1,-338,0.675606042,0.324393988,1,-338,-577,392,10,-200,-16
23,2/6/2014,0,1,16107,0,28,0.48332417,0.5166758,-1,-28,-605,80,84,-28,-44
24,2/7/2014,1,0,16108,1,-5,0.659678996,0.340321019,1,-5,-610,161,117,-5,-49
25,2/10/2014,1,0,16111,1,-137,0.538731366,0.461268678,1,-137,-747,185,4,-137,-186
26,2/11/2014,1,0,16112,1,365,0.587388575,0.412611455,1,365,-382,27,461,365,179
27,2/12/2014,1,0,16113,1,256,0.55892396,0.44107601,1,256,-126,59,294,256,435
28,2/13/2014,0,1,16114,0,-80,0.391403943,0.608596057,-1,80,-46,175,32,80,515
29,2/14/2014,1,0,16115,1,35,0.619890332,0.380109727,1,35,-11,79,121,35,550
30,2/17/2014,1,0,16118,1,149,0.639209032,0.360790938,1,149,138,0,207,149,699
31,2/18/2014,1,0,16119,1,1,0.609376937,0.390623108,1,1,139,146,26,1,700
32,2/19/2014,1,0,16120,1,86,0.575805277,0.424194738,1,86,225,45,171,86,786
33,2/20/2014,0,1,16121,0,-166,0.461099684,0.538900316,-1,166,391,290,211,-200,586
34,2/21/2014,0,1,16122,0,-99,0.494869351,0.505130589,-1,99,490,225,10,99,685
35,2/24/2014,0,1,16125,0,-252,0.492408171,0.507591814,-1,252,742,385,12,252,937
36,2/25/2014,1,0,16126,1,-120,0.612482816,0.387517154,1,-120,622,226,94,-200,737
37,2/26/2014,0,1,16127,0,122,0.488206357,0.511793643,-1,-122,500,27,224,-200,537
38,2/27/2014,0,1,16128,0,298,0.450262904,0.549737126,-1,-298,202,29,304,-200,337
39,2/28/2014,1,0,16129,1,19,0.678373158,0.321626857,1,19,221,144,149,19,356
40,3/3/2014,0,1,16132,0,-98,0.418818891,0.581181109,-1,98,319,159,187,98,454
41,3/4/2014,1,0,16133,1,193,0.647768646,0.352231324,1,193,512,3,297,193,647
42,3/5/2014,0,1,16134,0,-235,0.293998033,0.706001937,-1,235,747,338,46,235,882
43,3/6/2014,1,0,16135,1,113,0.574971259,0.425028756,1,113,860,49,207,113,995
44,3/7/2014,0,1,16136,0,-69,0.393144026,0.606855989,-1,69,929,148,110,69,1064
45,3/10/2014,0,1,16139,0,-178,0.32074964,0.67925036,-1,178,1107,263,6,178,1242
46,3/11/2014,0,1,16140,0,40,0.451682523,0.548317522,-1,-40,1067,75,95,-40,1202
47,3/12/2014,0,1,16141,0,-130,0.43901971,0.56098035,-1,130,1197,184,13,130,1332
48,3/13/2014,1,0,16142,1,-149,0.611284614,0.388715401,1,-149,1048,186,126,-149,1183
49,3/14/2014,0,1,16143,0,-58,0.457104176,0.542895794,-1,58,1106,108,72,58,1241
50,3/17/2014,1,0,16146,1,32,0.570423335,0.42957665,1,32,1138,0,178,32,1273
51,3/18/2014,0,1,16147,0,80,0.439086407,0.560913593,-1,-80,1058,49,115,-80,1193
52,3/19/2014,1,0,16148,1,-63,0.601898074,0.398101941,1,-63,995,146,14,-63,1130
53,3/20/2014,0,1,16149,0,-200,0.382349104,0.617650896,-1,200,1195,248,100,200,1330
54,3/21/2014,1,0,16150,1,221,0.639964253,0.360035688,1,221,1416,69,237,221,1551
55,3/24/2014,1,0,16153,1,145,0.708577007,0.291422933,1,145,1561,116,202,145,1696
56,3/25/2014,1,0,16154,1,2,0.636798412,0.363201559,1,2,1563,36,106,2,1698
57,3/26/2014,1,0,16155,1,-33,0.526211649,0.473788351,1,-33,1530,60,97,-33,1665
58,3/27/2014,1,0,16156,1,-33,0.668475091,0.331524938,1,-33,1497,155,69,-33,1632
59,3/28/2014,1,0,16157,1,231,0.600100845,0.399899155,1,231,1728,0,261,231,1863
60,3/31/2014,0,1,16160,0,-56,0.344383448,0.655616581,-1,56,1784,186,5,56,1919
61,4/1/2014,1,0,16161,1,262,0.540755749,0.459244251,1,262,2046,20,295,262,2181
62,4/2/2014,1,0,16162,1,8,0.535374463,0.464625567,1,8,2054,109,64,8,2189
63,4/3/2014,1,0,16163,1,3,0.521156251,0.478843778,1,3,2057,25,199,3,2192
64,4/4/2014,0,1,16164,0,19,0.414730832,0.585269123,-1,-19,2038,56,89,-19,2173
65,4/7/2014,1,0,16167,1,-25,0.630114675,0.369885325,1,-25,2013,122,90,-25,2148
66,4/8/2014,1,0,16168,1,250,0.665735185,0.334264845,1,250,2263,45,270,250,2398
67,4/9/2014,1,0,16169,1,173,0.618882835,0.38111715,1,173,2436,33,269,173,2571
68,4/10/2014,0,1,16170,0,312,0.469320655,0.530679375,-1,-312,2124,225,322,-200,2371
69,4/11/2014,1,0,16171,1,-186,0.656187147,0.343812823,1,-186,1938,243,65,-200,2171
70,4/14/2014,1,0,16174,1,152,0.61775282,0.382247165,1,152,2090,34,192,152,2323
71,4/15/2014,0,1,16175,0,-437,0.3983794,0.601620585,-1,437,2527,463,28,437,2760
72,4/16/2014,0,1,16176,0,51,0.311126292,0.688873708,-1,-51,2476,52,240,-200,2560
73,4/17/2014,0,1,16177,0,-28,0.426290035,0.573709995,-1,28,2504,144,65,28,2588
74,4/22/2014,0,1,16182,0,29,0.486943305,0.513056725,-1,-29,2475,95,119,-29,2559
75,4/23/2014,0,1,16183,0,-332,0.457066149,0.542933822,-1,332,2807,340,22,332,2891
76,4/24/2014,1,0,16184,1,43,0.582309484,0.41769053,1,43,2850,25,88,43,2934
77,4/25/2014,1,0,16185,1,-274,0.561456561,0.438543424,1,-274,2576,299,120,-200,2734
78,4/28/2014,1,0,16188,1,59,0.563230842,0.436769143,1,59,2635,7,118,59,2793
79,4/29/2014,0,1,16189,0,53,0.497252464,0.502747595,-1,-53,2582,54,71,-53,2740
80,4/30/2014,1,0,16190,1,-472,0.560216039,0.439783975,1,-472,2110,493,6,-200,2540
81,5/2/2014,1,0,16192,1,189,0.533959687,0.466040269,1,189,2299,0,260,189,2729
82,5/5/2014,1,0,16195,1,-235,0.697152257,0.302847743,1,-235,2064,327,160,-200,2529
83,5/7/2014,1,0,16197,1,-186,0.712001562,0.287998438,1,-186,1878,257,24,-200,2329
84,5/8/2014,1,0,16198,1,-13,0.67999357,0.320006415,1,-13,1865,84,134,-13,2316
85,5/9/2014,0,1,16199,0,75,0.382573366,0.617426664,-1,-75,1790,98,151,-75,2241
86,5/12/2014,0,1,16202,0,375,0.446958154,0.553041816,-1,-375,1415,133,537,-200,2041
87,5/13/2014,0,1,16203,0,-3,0.466819495,0.533180535,-1,3,1418,98,48,3,2044
88,5/14/2014,1,0,16204,1,116,0.617708117,0.382291883,1,116,1534,67,280,116,2160
89,5/15/2014,1,0,16205,1,81,0.687723935,0.312276065,1,81,1615,9,211,81,2241
90,5/16/2014,1,0,16206,1,127,0.593650967,0.406349018,1,127,1742,50,140,127,2368
91,5/19/2014,0,1,16209,0,-101,0.416893199,0.583106846,-1,101,1843,285,10,101,2469
92,5/20/2014,0,1,16210,0,53,0.47978501,0.520214975,-1,-53,1790,74,139,-53,2416
93,5/21/2014,1,0,16211,1,117,0.5642232,0.435776755,1,117,1907,102,159,117,2533
94,5/22/2014,0,1,16212,0,42,0.463274509,0.536725521,-1,-42,1865,48,149,-42,2491
95,5/23/2014,0,1,16213,0,-9,0.489978388,0.510021567,-1,9,1874,78,40,9,2500
96,5/26/2014,1,0,16216,1,-72,0.503927559,0.496072471,1,-72,1802,152,129,-72,2428
97,5/27/2014,0,1,16217,0,-12,0.484905154,0.515094876,-1,12,1814,91,27,12,2440
98,5/28/2014,0,1,16218,0,51,0.34970209,0.65029794,-1,-51,1763,51,232,-200,2240
99,5/29/2014,1,0,16219,1,98,0.630542547,0.369457424,1,98,1861,0,162,98,2338
100,5/30/2014,0,1,16220,0,-29,0.337564304,0.662435681,-1,29,1890,109,95,29,2367
101,6/3/2014,0,1,16224,0,4,0.349329337,0.650670648,-1,-4,1886,125,130,-4,2363
102,6/4/2014,0,1,16225,0,-136,0.369647011,0.630353004,-1,136,2022,161,0,136,2499
103,6/5/2014,0,1,16226,0,-15,0.33839564,0.661604345,-1,15,2037,102,68,15,2514
104,6/6/2014,1,0,16227,1,-336,0.597840011,0.402160004,1,-336,1701,344,8,-200,2314
105,6/9/2014,1,0,16230,1,66,0.594578475,0.40542151,1,66,1767,26,108,66,2380
106,6/10/2014,1,0,16231,1,75,0.666983634,0.333016321,1,75,1842,168,164,75,2455
107,6/11/2014,1,0,16232,1,-34,0.534027219,0.465972811,1,-34,1808,114,5,-34,2421
108,6/12/2014,1,0,16233,1,95,0.576482683,0.423517331,1,95,1903,68,138,95,2516
109,6/13/2014,1,0,16234,1,224,0.596472561,0.403527439,1,224,2127,37,345,224,2740
110,6/16/2014,0,1,16237,0,21,0.397933915,0.60206607,-1,-21,2106,32,105,-21,2719
111,6/17/2014,0,1,16238,0,-25,0.407817841,0.59218213,-1,25,2131,120,32,25,2744
112,6/18/2014,0,1,16239,0,66,0.409732133,0.590267867,-1,-66,2065,7,171,-66,2678
113,6/19/2014,1,0,16240,1,-119,0.666871727,0.333128259,1,-119,1946,200,32,-200,2478
114,6/20/2014,0,1,16241,0,-68,0.427008033,0.572991937,-1,68,2014,83,74,68,2546
115,6/23/2014,1,0,16244,1,-323,0.51953721,0.48046276,1,-323,1691,342,388,-200,2346
116,6/24/2014,1,0,16245,1,52,0.520631164,0.479368851,1,52,1743,22,109,52,2398
117,6/25/2014,0,1,16246,0,59,0.451534182,0.548465788,-1,-59,1684,38,110,-59,2339
118,6/26/2014,0,1,16247,0,262,0.47965014,0.52034983,-1,-262,1422,29,301,-200,2139
119,6/27/2014,1,0,16248,1,61,0.602240264,0.397759765,1,61,1483,1,166,61,2200
120,6/30/2014,0,1,16251,0,-66,0.489913806,0.510086209,-1,66,1549,406,85,66,2266
121,7/2/2014,0,1,16253,0,222,0.300390214,0.699609786,-1,-222,1327,65,253,-200,2066
122,7/3/2014,0,1,16254,0,3,0.441164255,0.558835745,-1,-3,1324,49,71,-3,2063
123,7/4/2014,1,0,16255,1,-45,0.534106225,0.465893775,1,-45,1279,90,47,-45,2018
124,7/7/2014,0,1,16258,0,-32,0.456351012,0.543648988,-1,32,1311,139,26,32,2050
125,7/8/2014,0,1,16259,0,49,0.479665592,0.520334423,-1,-49,1262,35,84,-49,2001
126,7/9/2014,1,0,16260,1,-291,0.636936516,0.363063499,1,-291,971,339,7,-200,1801
127,7/10/2014,1,0,16261,1,-73,0.623081565,0.376918405,1,-73,898,115,12,-73,1728
128,7/11/2014,1,0,16262,1,118,0.675911307,0.324088678,1,118,1016,65,240,118,1846
129,7/14/2014,1,0,16265,1,92,0.64134118,0.358658865,1,92,1108,46,223,92,1938
130,7/15/2014,0,1,16266,0,6,0.415567413,0.584432632,-1,-6,1102,43,65,-6,1932
131,7/16/2014,0,1,16267,0,39,0.388596788,0.611403227,-1,-39,1063,56,114,-39,1893
132,7/17/2014,0,1,16268,0,-107,0.433549955,0.56645003,-1,107,1170,198,20,107,2000
133,7/18/2014,1,0,16269,1,131,0.529295444,0.47070457,1,131,1301,73,206,131,2131
134,7/21/2014,0,1,16272,0,-125,0.426373199,0.573626786,-1,125,1426,144,43,125,2256
135,7/22/2014,1,0,16273,1,393,0.611349523,0.388650477,1,393,1819,18,438,393,2649
136,7/23/2014,0,1,16274,0,130,0.487830728,0.512169302,-1,-130,1689,26,151,-130,2519
137,7/24/2014,0,1,16275,0,144,0.475996375,0.524003655,-1,-144,1545,21,160,-144,2375
138,7/25/2014,1,0,16276,1,68,0.533600986,0.466399029,1,68,1613,92,83,68,2443
139,7/28/2014,0,1,16279,0,163,0.483252257,0.516747773,-1,-163,1450,40,275,-200,2243
140,7/29/2014,0,1,16280,0,182,0.353249446,0.646750569,-1,-182,1268,40,235,-200,2043
141,7/30/2014,0,1,16281,0,115,0.441609532,0.558390468,-1,-115,1153,39,211,-200,1843
142,7/31/2014,0,1,16282,0,-4,0.284324795,0.715675175,-1,4,1157,124,105,4,1847
143,8/1/2014,1,0,16283,1,-50,0.521757126,0.478242844,1,-50,1107,93,172,-50,1797
144,8/4/2014,1,0,16286,1,37,0.537525773,0.462474287,1,37,1144,3,190,37,1834
145,8/5/2014,1,0,16287,1,11,0.563240588,0.436759397,1,11,1155,150,100,11,1845
146,8/6/2014,1,0,16288,1,50,0.548531771,0.451468185,1,50,1205,107,91,50,1895
147,8/7/2014,1,0,16289,1,-77,0.603578627,0.396421343,1,-77,1128,130,21,-77,1818
148,8/8/2014,0,1,16290,0,65,0.405864745,0.594135284,-1,-65,1063,109,240,-200,1618
149,8/11/2014,0,1,16293,0,91,0.396039456,0.603960574,-1,-91,972,72,113,-91,1527
150,8/12/2014,1,0,16294,1,42,0.641133696,0.358866334,1,42,1014,111,52,42,1569
151,8/13/2014,0,1,16295,0,242,0.367886275,0.632113755,-1,-242,772,95,257,-200,1369
152,8/14/2014,0,1,16296,0,-180,0.358541533,0.641458482,-1,180,952,265,19,180,1549
153,8/15/2014,0,1,16297,0,46,0.455863759,0.544136256,-1,-46,906,36,114,-46,1503
154,8/18/2014,1,0,16300,1,47,0.649080992,0.350919008,1,47,953,160,78,47,1550
155,8/19/2014,0,1,16301,0,156,0.354972199,0.645027816,-1,-156,797,94,226,-200,1350
156,8/20/2014,0,1,16302,0,3,0.381437883,0.618562073,-1,-3,794,56,79,-3,1347
157,8/21/2014,0,1,16303,0,-136,0.419034451,0.580965549,-1,136,930,226,16,136,1483
158,8/22/2014,0,1,16304,0,58,0.367716148,0.632283837,-1,-58,872,14,113,-58,1425
159,8/25/2014,0,1,16307,0,164,0.444908559,0.555091441,-1,-164,708,101,245,-200,1225
160,8/26/2014,0,1,16308,0,-23,0.455715701,0.544284254,-1,23,731,40,65,23,1248
161,8/27/2014,0,1,16309,0,-145,0.443406492,0.556593448,-1,145,876,218,105,145,1393
162,8/28/2014,1,0,16310,1,-57,0.58598581,0.414014161,1,-57,819,70,105,-57,1336
163,8/29/2014,0,1,16311,0,51,0.311347112,0.688652903,-1,-51,768,57,126,-51,1285
164,9/1/2014,0,1,16314,0,97,0.401202664,0.598797381,-1,-97,671,7,251,-200,1085
165,9/2/2014,0,1,16315,0,32,0.420736894,0.579263121,-1,-32,639,135,113,-32,1053
166,9/3/2014,1,0,16316,1,626,0.500199765,0.49980022,1,626,1265,54,643,626,1679
167,9/4/2014,0,1,16317,0,-11,0.480630115,0.519369841,-1,11,1276,45,132,11,1690
168,9/5/2014,0,1,16318,0,-89,0.362485409,0.637514591,-1,89,1365,141,17,89,1779
169,9/8/2014,0,1,16321,0,-67,0.358633652,0.641366363,-1,67,1432,218,28,67,1846
170,9/10/2014,0,1,16323,0,-325,0.406773672,0.593226343,-1,325,1757,354,10,325,2171
171,9/11/2014,0,1,16324,0,-32,0.311535329,0.688464731,-1,32,1789,124,59,32,2203
172,9/12/2014,1,0,16325,1,-56,0.518731028,0.481268913,1,-56,1733,173,69,-56,2147
173,9/15/2014,0,1,16328,0,-35,0.301646367,0.698353648,-1,35,1768,164,44,35,2182
174,9/16/2014,0,1,16329,0,-167,0.456962585,0.543037415,-1,167,1935,209,78,167,2349
175,9/17/2014,0,1,16330,0,-52,0.49996461,0.50003539,-1,52,1987,71,58,52,2401
176,9/18/2014,0,1,16331,0,-167,0.305766627,0.694233388,-1,167,2154,248,18,167,2568
177,9/19/2014,0,1,16332,0,-8,0.333454818,0.666545182,-1,8,2162,177,118,8,2576
178,9/22/2014,0,1,16335,0,-82,0.420282587,0.579717398,-1,82,2244,143,7,82,2658
179,9/23/2014,0,1,16336,0,-27,0.496582672,0.503417403,-1,27,2271,45,165,27,2685
180,9/24/2014,1,0,16337,1,92,0.618293047,0.381706938,1,92,2363,11,206,92,2777
181,9/25/2014,1,0,16338,1,-277,0.504658908,0.495341063,1,-277,2086,303,10,-200,2577
182,9/26/2014,0,1,16339,0,136,0.478415444,0.521584511,-1,-136,1950,2,174,-136,2441
183,9/29/2014,0,1,16342,0,28,0.369833902,0.630166113,-1,-28,1922,83,226,-200,2241
184,9/30/2014,0,1,16343,0,-186,0.499058291,0.500941783,-1,186,2108,206,139,186,2427
185,10/3/2014,1,0,16346,1,393,0.505342007,0.494657934,1,393,2501,89,500,393,2820
186,10/6/2014,0,1,16349,0,276,0.413221821,0.586778164,-1,-276,2225,97,419,-200,2620
187,10/7/2014,1,0,16350,1,121,0.604604274,0.395395696,1,121,2346,83,238,121,2741
188,10/8/2014,1,0,16351,1,26,0.614898145,0.385101825,1,26,2372,94,140,26,2767
189,10/9/2014,0,1,16352,0,65,0.484336182,0.515663832,-1,-65,2307,57,102,-65,2702
190,10/10/2014,1,0,16353,1,-95,0.617551506,0.38244848,1,-95,2212,117,84,-95,2607
191,10/13/2014,0,1,16356,0,337,0.477558568,0.522441477,-1,-337,1875,36,423,-200,2407
192,10/14/2014,1,0,16357,1,-70,0.657275856,0.34272413,1,-70,1805,84,375,-70,2337
193,10/15/2014,1,0,16358,1,29,0.66719541,0.332804635,1,29,1834,147,164,29,2366
194,10/16/2014,1,0,16359,1,-49,0.55748561,0.442514405,1,-49,1785,115,120,-49,2317
195,10/17/2014,1,0,16360,1,102,0.594738483,0.405261531,1,102,1887,90,199,102,2419
196,10/20/2014,0,1,16363,0,-222,0.472910285,0.527089715,-1,222,2109,248,42,222,2641
197,10/21/2014,0,1,16364,0,48,0.361182258,0.638817728,-1,-48,2061,157,165,-48,2593
198,10/22/2014,0,1,16365,0,87,0.445680052,0.554319978,-1,-87,1974,98,194,-87,2506
199,10/23/2014,0,1,16366,0,105,0.450585961,0.549414068,-1,-105,1869,35,149,-105,2401
200,10/24/2014,0,1,16367,0,-10,0.281553894,0.718446136,-1,10,1879,233,45,10,2411
201,10/27/2014,1,0,16370,1,-32,0.509943098,0.490056902,1,-32,1847,270,43,-200,2211
202,10/28/2014,1,0,16371,1,433,0.556854397,0.443145603,1,433,2280,0,457,433,2644
203,10/29/2014,1,0,16372,1,155,0.533696443,0.466303572,1,155,2435,18,221,155,2799
204,10/30/2014,0,1,16373,0,-139,0.293477848,0.706522137,-1,139,2574,151,26,139,2938
205,10/31/2014,1,0,16374,1,105,0.522264779,0.477735266,1,105,2679,16,242,105,3043
206,11/3/2014,0,1,16377,0,-170,0.381105602,0.618894368,-1,170,2849,183,87,170,3213
207,11/4/2014,0,1,16378,0,46,0.365625665,0.634374321,-1,-46,2803,2,267,-200,3013
208,11/5/2014,0,1,16379,0,-104,0.376086324,0.623913676,-1,104,2907,219,82,104,3117
209,11/6/2014,0,1,16380,0,-74,0.436473578,0.563526392,-1,74,2981,114,71,74,3191
210,11/7/2014,0,1,16381,0,-126,0.266662985,0.733337015,-1,126,3107,244,218,-200,2991
211,11/10/2014,1,0,16384,1,-359,0.651531458,0.348468527,1,-359,2748,429,99,-200,2791
212,11/11/2014,0,1,16385,0,8,0.317723811,0.682276189,-1,-8,2740,29,182,-8,2783
213,11/12/2014,0,1,16386,0,112,0.353429988,0.646569997,-1,-112,2628,35,215,-200,2583
214,11/13/2014,0,1,16387,0,175,0.357851624,0.642148376,-1,-175,2453,1,289,-200,2383
215,11/14/2014,0,1,16388,0,69,0.252388388,0.747611582,-1,-69,2384,17,126,-69,2314
216,11/17/2014,0,1,16391,0,-467,0.480978578,0.519021362,-1,467,2851,507,105,467,2781
217,11/18/2014,0,1,16392,0,-399,0.31381005,0.686189979,-1,399,3250,406,29,399,3180
218,11/19/2014,0,1,16393,0,-145,0.458943918,0.541056097,-1,145,3395,148,73,145,3325
219,11/20/2014,0,1,16394,0,-27,0.393481821,0.606518179,-1,27,3422,94,121,27,3352
220,11/21/2014,1,0,16395,1,114,0.674173176,0.325826809,1,114,3536,52,224,114,3466
221,11/24/2014,1,0,16398,1,13,0.730524361,0.269475654,1,13,3549,56,98,13,3479
222,11/25/2014,0,1,16399,0,75,0.381993979,0.618006021,-1,-75,3474,5,116,-75,3404
223,11/26/2014,0,1,16400,0,307,0.303165957,0.696834028,-1,-307,3167,28,353,-200,3204
224,11/27/2014,0,1,16401,0,-147,0.31282264,0.68717736,-1,147,3314,178,76,147,3351
225,11/28/2014,0,1,16402,0,-32,0.339715004,0.660284996,-1,32,3346,96,149,32,3383
226,12/1/2014,0,1,16405,0,-542,0.293276772,0.706723243,-1,542,3888,582,154,542,3925
227,12/2/2014,0,1,16406,0,394,0.249843031,0.750156969,-1,-394,3494,22,518,-200,3725
228,12/3/2014,0,1,16407,0,-303,0.27112031,0.72887972,-1,303,3797,384,212,-200,3525
229,12/4/2014,1,0,16408,1,340,0.59458366,0.405416325,1,340,4137,66,385,340,3865
230,12/5/2014,0,1,16409,0,181,0.458475187,0.541524798,-1,-181,3956,150,316,-200,3665
231,12/8/2014,0,1,16412,0,-54,0.359959245,0.640040755,-1,54,4010,69,145,54,3719
232,12/9/2014,0,1,16413,0,-464,0.409433812,0.590566158,-1,464,4474,573,0,464,4183
233,12/10/2014,1,0,16414,1,151,0.652373284,0.347626716,1,151,4625,44,328,151,4334
234,12/11/2014,0,1,16415,0,83,0.490739569,0.509260386,-1,-83,4542,150,128,-83,4251
235,12/12/2014,0,1,16416,0,-76,0.330152035,0.669847965,-1,76,4618,76,170,76,4327
236,12/15/2014,0,1,16419,0,-14,0.394672319,0.605327696,-1,14,4632,168,86,14,4341
237,12/16/2014,0,1,16420,0,-177,0.244280308,0.755719721,-1,177,4809,180,126,177,4518
238,12/17/2014,0,1,16421,0,-30,0.249781184,0.750218809,-1,30,4839,127,78,30,4548
239,12/18/2014,1,0,16422,1,-62,0.668880343,0.331119671,1,-62,4777,159,58,-62,4486
240,12/19/2014,0,1,16423,0,76,0.351506814,0.648493201,-1,-76,4701,74,104,-76,4410
241,12/22/2014,1,0,16426,1,227,0.687855154,0.312144816,1,227,4928,4,274,227,4637
242,12/23/2014,1,0,16427,1,-92,0.720841289,0.279158711,1,-92,4836,171,53,-92,4545
243,12/24/2014,0,1,16428,0,37,0.312811598,0.687188387,-1,-37,4799,28,102,-37,4508
244,12/29/2014,0,1,16433,0,92,0.307960153,0.692039847,-1,-92,4707,19,202,-200,4308
245,12/30/2014,0,1,16434,0,-303,0.402277574,0.597722411,-1,303,5010,310,34,303,4611
246,12/31/2014,0,1,16435,0,180,0.454470888,0.545529127,-1,-180,4830,5,207,-200,4411
0,1/2/2015,0,1,16437,0,140,0.332904056,0.667095929,-1,-140,-140,48,174,-140,-140
1,1/5/2015,1,0,16440,1,162,0.724434346,0.275565699,1,162,22,24,431,162,22
2,1/6/2015,1,0,16441,1,-79,0.574011564,0.425988391,1,-79,-57,236,63,-200,-178
3,1/7/2015,0,1,16442,0,311,0.443835452,0.556164533,-1,-311,-368,43,402,-200,-378
4,1/8/2015,1,0,16443,1,35,0.522436768,0.477563262,1,35,-333,90,115,35,-343
5,1/9/2015,0,1,16444,0,-160,0.380426422,0.619573623,-1,160,-173,244,98,160,-183
6,1/12/2015,1,0,16447,1,15,0.726579338,0.273420632,1,15,-158,137,85,15,-168
7,1/13/2015,0,1,16448,0,315,0.433397785,0.5666022,-1,-315,-473,23,358,-200,-368
8,1/14/2015,0,1,16449,0,-144,0.260573044,0.739426941,-1,144,-329,227,57,144,-224
9,1/15/2015,1,0,16450,1,218,0.746592581,0.253407404,1,218,-111,96,276,218,-6
10,1/16/2015,1,0,16451,1,-41,0.729789883,0.270210117,1,-41,-152,163,20,-41,-47
11,1/19/2015,0,1,16454,0,-330,0.299699575,0.700300425,-1,330,178,497,46,330,283
12,1/20/2015,0,1,16455,0,169,0.333230451,0.666769594,-1,-169,9,92,199,-169,114
13,1/21/2015,0,1,16456,0,285,0.425620109,0.574379891,-1,-285,-276,62,359,-200,-86
14,1/22/2015,1,0,16457,1,155,0.583138615,0.416861415,1,155,-121,36,174,155,69
15,1/23/2015,0,1,16458,0,146,0.351910859,0.648089111,-1,-146,-267,40,152,-146,-77
16,1/26/2015,1,0,16461,1,18,0.547519863,0.452480167,1,18,-249,88,81,18,-59
17,1/27/2015,0,1,16462,0,-215,0.319425702,0.680574268,-1,215,-34,309,27,215,156
18,1/28/2015,1,0,16463,1,113,0.629945576,0.370054439,1,113,79,49,237,113,269
19,1/29/2015,0,1,16464,0,-54,0.381643608,0.618356407,-1,54,133,82,81,54,323
20,1/30/2015,0,1,16465,0,-215,0.256632999,0.743367016,-1,215,348,298,22,215,538
21,2/2/2015,1,0,16468,1,116,0.663770765,0.336229235,1,116,464,38,146,116,654
22,2/3/2015,0,1,16469,0,-33,0.476202488,0.523797512,-1,33,497,259,47,33,687
23,2/4/2015,1,0,16470,1,-110,0.596125484,0.403874502,1,-110,387,134,80,-110,577
24,2/5/2015,0,1,16471,0,-214,0.485729724,0.514270306,-1,214,601,361,190,214,791
25,2/6/2015,0,1,16472,0,-198,0.276453719,0.723546296,-1,198,799,204,34,198,989
26,2/9/2015,0,1,16475,0,19,0.282888204,0.717111796,-1,-19,780,67,187,-19,970
27,2/10/2015,1,0,16476,1,72,0.672340363,0.327659622,1,72,852,60,165,72,1042
28,2/11/2015,0,1,16477,0,-205,0.270931095,0.729068875,-1,205,1057,281,49,205,1247
29,2/12/2015,1,0,16478,1,130,0.538276643,0.461723328,1,130,1187,87,249,130,1377
30,2/13/2015,0,1,16479,0,222,0.430449039,0.569550961,-1,-222,965,0,228,-200,1177
31,2/16/2015,1,0,16482,1,7,0.611952543,0.388047457,1,7,972,41,53,7,1184
32,2/17/2015,1,0,16483,1,162,0.584573656,0.415426344,1,162,1134,8,224,162,1346
33,2/18/2015,0,1,16484,0,24,0.293105215,0.706894755,-1,-24,1110,1,71,-24,1322
34,2/23/2015,0,1,16489,0,-117,0.426761702,0.573238313,-1,117,1227,346,6,117,1439
35,2/24/2015,0,1,16490,0,-6,0.469035134,0.530964911,-1,6,1233,108,15,6,1445
36,2/25/2015,1,0,16491,1,-27,0.714169055,0.28583096,1,-27,1206,151,63,-27,1418
37,2/26/2015,1,0,16492,1,47,0.629907399,0.370092601,1,47,1253,84,141,47,1465
38,2/27/2015,0,1,16493,0,32,0.476206586,0.523793399,-1,-32,1221,19,286,-200,1265
39,3/2/2015,1,0,16496,1,-127,0.666517645,0.333482385,1,-127,1094,343,57,-200,1065
40,3/3/2015,0,1,16497,0,-264,0.26574491,0.734255075,-1,264,1358,306,16,264,1329
41,3/4/2015,0,1,16498,0,-116,0.414831311,0.58516866,-1,116,1474,146,177,116,1445
42,3/5/2015,1,0,16499,1,-105,0.587331027,0.412668988,1,-105,1369,174,93,-105,1340
43,3/6/2015,0,1,16500,0,-37,0.385577127,0.614422858,-1,37,1406,89,87,37,1377
44,3/9/2015,0,1,16503,0,150,0.315749466,0.684250563,-1,-150,1256,39,250,-200,1177
45,3/10/2015,0,1,16504,0,-180,0.29348278,0.70651722,-1,180,1436,245,61,180,1357
46,3/11/2015,1,0,16505,1,-68,0.609636903,0.390363127,1,-68,1368,79,156,-68,1289
47,3/12/2015,1,0,16506,1,109,0.570238143,0.429761827,1,109,1477,16,189,109,1398
48,3/13/2015,0,1,16507,0,-8,0.290980622,0.709019393,-1,8,1485,40,116,8,1406
49,3/16/2015,0,1,16510,0,218,0.380223721,0.619776309,-1,-218,1267,68,235,-200,1206
50,3/17/2015,0,1,16511,0,-114,0.317535713,0.682464272,-1,114,1381,233,63,114,1320
51,3/18/2015,1,0,16512,1,204,0.710948586,0.289051399,1,204,1585,17,295,204,1524
52,3/19/2015,1,0,16513,1,300,0.751343697,0.248656288,1,300,1885,1,316,300,1824
53,3/20/2015,1,0,16514,1,-16,0.603203475,0.39679651,1,-16,1869,65,105,-16,1808
54,3/23/2015,0,1,16517,0,-12,0.497187048,0.502812967,-1,12,1881,77,75,12,1820
55,3/24/2015,1,0,16518,1,-41,0.581260413,0.418739557,1,-41,1840,166,22,-41,1779
56,3/25/2015,1,0,16519,1,116,0.60981971,0.390180305,1,116,1956,48,192,116,1895
57,3/26/2015,0,1,16520,0,136,0.419744059,0.580255896,-1,-136,1820,16,238,-200,1695
58,3/27/2015,0,1,16521,0,56,0.252100147,0.74789983,-1,-56,1764,51,87,-56,1639
59,3/30/2015,1,0,16524,1,223,0.578130752,0.421869263,1,223,1987,0,238,223,1862
60,3/31/2015,0,1,16525,0,-24,0.335657015,0.66434297,-1,24,2011,74,81,24,1886
61,4/1/2015,1,0,16526,1,239,0.659931272,0.340068743,1,239,2250,1,279,239,2125
62,4/2/2015,1,0,16527,1,-4,0.742181122,0.257818893,1,-4,2246,68,118,-4,2121
63,4/8/2015,1,0,16533,1,664,0.635348022,0.364651963,1,664,2910,0,713,664,2785
64,4/9/2015,0,1,16534,0,362,0.27956076,0.720439225,-1,-362,2548,3,1288,-200,2585
65,4/10/2015,0,1,16535,0,-300,0.430284575,0.569715381,-1,300,2848,722,30,300,2885
66,4/13/2015,0,1,16538,0,640,0.422876954,0.577123076,-1,-640,2208,199,735,-200,2685
67,4/14/2015,0,1,16539,0,-129,0.349026844,0.650973141,-1,129,2337,209,217,-200,2485
68,4/15/2015,1,0,16540,1,-59,0.626842678,0.373157352,1,-59,2278,222,184,-200,2285
69,4/16/2015,1,0,16541,1,90,0.624295026,0.375705004,1,90,2368,176,195,90,2375
70,4/17/2015,1,0,16542,1,-120,0.590732396,0.409267604,1,-120,2248,183,194,-120,2255
71,4/20/2015,1,0,16545,1,-474,0.73234877,0.267651245,1,-474,1774,597,318,-200,2055
72,4/21/2015,0,1,16546,0,416,0.252258249,0.747741789,-1,-416,1358,47,524,-200,1855
73,4/22/2015,0,1,16547,0,-129,0.294044256,0.705955744,-1,129,1487,198,157,129,1984
74,4/23/2015,0,1,16548,0,-328,0.407616258,0.592383742,-1,328,1815,335,88,328,2312
75,4/24/2015,1,0,16549,1,103,0.710109234,0.289890766,1,103,1918,348,165,-200,2112
76,4/27/2015,0,1,16552,0,290,0.405204639,0.594795316,-1,-290,1628,30,501,-200,1912
77,4/28/2015,0,1,16553,0,35,0.368869394,0.631130606,-1,-35,1593,168,112,-35,1877
78,4/29/2015,0,1,16554,0,-153,0.259661376,0.740338653,-1,153,1746,260,0,153,2030
79,4/30/2015,0,1,16555,0,-47,0.453720123,0.546279877,-1,47,1793,220,136,47,2077
80,5/4/2015,0,1,16559,0,76,0.284001917,0.715998054,-1,-76,1717,129,278,-200,1877
81,5/5/2015,0,1,16560,0,-475,0.301502332,0.698497653,-1,475,2192,754,42,475,2352
82,5/6/2015,1,0,16561,1,50,0.554616958,0.445383042,1,50,2242,104,417,50,2402
83,5/7/2015,0,1,16562,0,-281,0.264093474,0.735906541,-1,281,2523,350,93,281,2683
84,5/8/2015,1,0,16563,1,172,0.562633187,0.437366828,1,172,2695,41,286,172,2855
85,5/11/2015,0,1,16566,0,-158,0.371861741,0.628138244,-1,158,2853,294,42,158,3013
86,5/12/2015,0,1,16567,0,-293,0.288279548,0.711720496,-1,293,3146,309,5,293,3306
87,5/13/2015,1,0,16568,1,-197,0.603748024,0.396251962,1,-197,2949,279,91,-200,3106
88,5/14/2015,0,1,16569,0,-31,0.468666062,0.531333923,-1,31,2980,155,39,31,3137
89,5/15/2015,0,1,16570,0,516,0.463649631,0.536350369,-1,-516,2464,95,582,-200,2937
90,5/18/2015,1,0,16573,1,-219,0.66186288,0.338137075,1,-219,2245,384,65,-200,2737
91,5/19/2015,0,1,16574,0,130,0.258919746,0.741080284,-1,-130,2115,125,148,-130,2607
92,5/20/2015,0,1,16575,0,-252,0.328341633,0.671658397,-1,252,2367,314,1,252,2859
93,5/21/2015,1,0,16576,1,94,0.553501308,0.446498692,1,94,2461,141,125,94,2953
94,5/22/2015,1,0,16577,1,332,0.520895362,0.479104623,1,332,2793,3,410,332,3285
95,5/26/2015,0,1,16581,0,-104,0.497946829,0.502053142,-1,104,2897,129,160,104,3389
96,5/27/2015,1,0,16582,1,-230,0.51640299,0.483597025,1,-230,2667,269,99,-200,3189
97,5/28/2015,0,1,16583,0,-524,0.303211421,0.696788579,-1,524,3191,574,49,524,3713
98,5/29/2015,0,1,16584,0,46,0.47914885,0.520851165,-1,-46,3145,171,197,-46,3667
99,6/1/2015,1,0,16587,1,170,0.548221618,0.451778352,1,170,3315,64,491,170,3837
100,6/2/2015,0,1,16588,0,16,0.289505154,0.710494816,-1,-16,3299,70,207,-200,3637
101,6/3/2015,1,0,16589,1,166,0.582167953,0.417832032,1,166,3465,21,317,166,3803
102,6/4/2015,0,1,16590,0,131,0.250954166,0.749045879,-1,-131,3334,681,341,-200,3603
103,6/5/2015,1,0,16591,1,-289,0.58119151,0.41880849,1,-289,3045,312,147,-200,3403
104,6/8/2015,0,1,16594,0,80,0.390740022,0.609259993,-1,-80,2965,145,255,-200,3203
105,6/9/2015,1,0,16595,1,-300,0.618005127,0.381994814,1,-300,2665,329,69,-200,3003
106,6/10/2015,0,1,16596,0,-319,0.465427443,0.534572572,-1,319,2984,414,179,319,3322
107,6/11/2015,0,1,16597,0,127,0.28126128,0.718738765,-1,-127,2857,48,128,-127,3195
108,6/12/2015,1,0,16598,1,329,0.673896968,0.326103032,1,329,3186,49,383,329,3524
109,6/15/2015,1,0,16601,1,-251,0.627111167,0.372888818,1,-251,2935,264,40,-200,3324
110,6/16/2015,1,0,16602,1,-252,0.644958079,0.355041906,1,-252,2683,258,118,-200,3124
111,6/17/2015,1,0,16603,1,219,0.68642512,0.313574851,1,219,2902,23,368,219,3343
112,6/18/2015,1,0,16604,1,24,0.645662189,0.354337826,1,24,2926,125,233,24,3367
113,6/19/2015,0,1,16605,0,-34,0.373508602,0.626491398,-1,34,2960,198,116,34,3401
114,6/22/2015,1,0,16608,1,229,0.58079198,0.419208005,1,229,3189,87,296,229,3630
115,6/23/2015,0,1,16609,0,267,0.285683095,0.714316964,-1,-267,2922,123,296,-200,3430
116,6/24/2015,0,1,16610,0,44,0.412715465,0.587284535,-1,-44,2878,54,96,-44,3386
117,6/25/2015,1,0,16611,1,-66,0.600291759,0.399708241,1,-66,2812,147,64,-66,3320
118,6/26/2015,0,1,16612,0,-293,0.290846407,0.709153593,-1,293,3105,609,21,293,3613
119,6/29/2015,0,1,16615,0,-628,0.344566882,0.655433148,-1,628,3733,777,70,628,4241
120,6/30/2015,1,0,16616,1,302,0.712041378,0.287958592,1,302,4035,27,594,302,4543
121,7/2/2015,0,1,16618,0,79,0.28309381,0.71690622,-1,-79,3956,136,186,-79,4464
122,7/3/2015,1,0,16619,1,-338,0.691039354,0.308960661,1,-338,3618,451,69,-200,4264
123,7/6/2015,0,1,16622,0,-694,0.496224761,0.503775254,-1,694,4312,1253,380,-200,4064
124,7/7/2015,1,0,16623,1,-413,0.71536684,0.284633204,1,-413,3899,595,31,-200,3864
125,7/8/2015,1,0,16624,1,-1227,0.689929485,0.31007053,1,-1227,2672,1689,92,-200,3664
126,7/9/2015,1,0,16625,1,1154,0.583978325,0.416021645,1,1154,3826,43,1382,1154,4818
127,7/10/2015,1,0,16626,1,443,0.571949422,0.428050548,1,443,4269,38,507,443,5261
128,7/13/2015,0,1,16629,0,330,0.411073536,0.588926464,-1,-330,3939,323,396,-200,5061
129,7/14/2015,1,0,16630,1,-182,0.551437855,0.448562175,1,-182,3757,350,0,-200,4861
130,7/15/2015,0,1,16631,0,-95,0.476701513,0.523298472,-1,95,3852,314,56,95,4956
131,7/16/2015,1,0,16632,1,-9,0.543906868,0.456093162,1,-9,3843,276,56,-200,4756
132,7/17/2015,0,1,16633,0,241,0.458447427,0.541552514,-1,-241,3602,48,306,-200,4556
133,7/20/2015,0,1,16636,0,-154,0.434720889,0.565279126,-1,154,3756,282,1,154,4710
134,7/21/2015,0,1,16637,0,146,0.279288724,0.720711291,-1,-146,3610,84,250,-200,4510
135,7/22/2015,1,0,16638,1,-156,0.619483203,0.380516812,1,-156,3454,249,10,-200,4310
136,7/23/2015,0,1,16639,0,106,0.377537474,0.622462541,-1,-106,3348,28,228,-200,4110
137,7/24/2015,1,0,16640,1,-120,0.534807056,0.465192944,1,-120,3228,263,0,-200,3910
138,7/27/2015,0,1,16643,0,-542,0.341945961,0.658054054,-1,542,3770,643,32,542,4452
139,7/28/2015,0,1,16644,0,122,0.445699662,0.554300278,-1,-122,3648,183,640,-200,4252
140,7/29/2015,0,1,16645,0,0,0.470035091,0.529964924,-1,0,3648,166,107,0,4252
141,7/30/2015,1,0,16646,1,-143,0.677293509,0.322706491,1,-143,3505,165,63,-143,4109
142,7/31/2015,0,1,16647,0,-4,0.375878379,0.624121606,-1,4,3509,120,192,4,4113
143,8/3/2015,0,1,16650,0,-257,0.456873968,0.543126017,-1,257,3766,423,15,257,4370
144,8/4/2015,0,1,16651,0,25,0.41200991,0.587990075,-1,-25,3741,95,240,-200,4170
145,8/5/2015,0,1,16652,0,102,0.44591713,0.554082841,-1,-102,3639,71,163,-102,4068
146,8/6/2015,0,1,16653,0,-246,0.259691581,0.740308404,-1,246,3885,326,0,246,4314
147,8/7/2015,1,0,16654,1,293,0.658898234,0.341101795,1,293,4178,38,431,293,4607
148,8/10/2015,0,1,16657,0,46,0.493436292,0.506563738,-1,-46,4132,375,193,-46,4561
149,8/11/2015,0,1,16658,0,-244,0.49841623,0.501583755,-1,244,4376,319,191,244,4805
150,8/12/2015,1,0,16659,1,-563,0.634712189,0.365287781,1,-563,3813,570,17,-200,4605
151,8/13/2015,1,0,16660,1,196,0.542256653,0.457743302,1,196,4009,79,225,196,4801
152,8/14/2015,0,1,16661,0,-45,0.335632473,0.664367527,-1,45,4054,94,123,45,4846
153,8/17/2015,0,1,16664,0,-224,0.374758855,0.625241101,-1,224,4278,348,9,224,5070
154,8/18/2015,0,1,16665,0,-468,0.40210028,0.597899705,-1,468,4746,506,85,468,5538
155,8/19/2015,0,1,16666,0,-440,0.331569865,0.66843012,-1,440,5186,449,12,440,5978
156,8/20/2015,1,0,16667,1,-165,0.695151091,0.304848865,1,-165,5021,317,145,-200,5778
157,8/21/2015,1,0,16668,1,184,0.611653715,0.388346329,1,184,5205,202,201,-200,5578
158,8/24/2015,1,0,16671,1,-562,0.616946518,0.383053467,1,-562,4643,613,100,-200,5378
159,8/25/2015,1,0,16672,1,775,0.720106214,0.279893771,1,775,5418,0,1056,775,6153
160,8/26/2015,0,1,16673,0,-250,0.385769308,0.614230692,-1,250,5668,349,334,-200,5953
161,8/27/2015,0,1,16674,0,183,0.264996499,0.735003471,-1,-183,5485,231,382,-200,5753
162,8/28/2015,1,0,16675,1,-261,0.747470737,0.252529249,1,-261,5224,280,23,-200,5553
163,8/31/2015,1,0,16678,1,-4,0.694936305,0.305063695,1,-4,5220,239,150,-200,5353
164,9/1/2015,1,0,16679,1,-458,0.728910834,0.271089152,1,-458,4762,471,148,-200,5153
165,9/2/2015,1,0,16680,1,-99,0.734743059,0.265256956,1,-99,4663,184,392,-99,5054
166,9/4/2015,1,0,16682,1,-235,0.674674362,0.325325578,1,-235,4428,308,152,-200,4854
167,9/7/2015,1,0,16685,1,23,0.720914423,0.279085562,1,23,4451,25,576,23,4877
168,9/8/2015,1,0,16686,1,754,0.677675545,0.322324485,1,754,5205,184,813,754,5631
169,9/9/2015,1,0,16687,1,471,0.615554273,0.384445727,1,471,5676,133,676,471,6102
170,9/10/2015,0,1,16688,0,-103,0.470262945,0.529737055,-1,103,5779,203,131,103,6205
171,9/11/2015,1,0,16689,1,-275,0.614770204,0.385229811,1,-275,5504,313,190,-200,6005
172,9/14/2015,0,1,16692,0,-146,0.491717383,0.508282617,-1,146,5650,287,65,146,6151
173,9/15/2015,1,0,16693,1,-147,0.717746198,0.282253757,1,-147,5503,155,105,-147,6004
174,9/16/2015,0,1,16694,0,310,0.342897743,0.657102257,-1,-310,5193,125,404,-200,5804
175,9/17/2015,1,0,16695,1,-370,0.715832084,0.284167916,1,-370,4823,492,71,-200,5604
176,9/18/2015,1,0,16696,1,344,0.733866751,0.266133279,1,344,5167,59,361,344,5948
177,9/21/2015,1,0,16699,1,55,0.733026654,0.266973361,1,55,5222,170,148,55,6003
178,9/22/2015,0,1,16700,0,-196,0.324388683,0.675611317,-1,196,5418,216,340,-200,5803
179,9/23/2015,1,0,16701,1,-153,0.715850085,0.28414993,1,-153,5265,522,99,-200,5603
180,9/24/2015,0,1,16702,0,-159,0.338494554,0.661505461,-1,159,5424,332,40,159,5762
181,9/25/2015,1,0,16703,1,207,0.740733296,0.259266689,1,207,5631,85,312,207,5969
182,9/29/2015,1,0,16707,1,-159,0.573120117,0.426879928,1,-159,5472,271,1,-200,5769
183,9/30/2015,1,0,16708,1,40,0.731779963,0.268220067,1,40,5512,101,166,40,5809
184,10/2/2015,1,0,16710,1,330,0.580238104,0.419761866,1,330,5842,72,351,330,6139
185,10/5/2015,1,0,16713,1,85,0.747590572,0.252409473,1,85,5927,61,218,85,6224
186,10/6/2015,0,1,16714,0,-373,0.370046675,0.629953235,-1,373,6300,455,12,373,6597
187,10/7/2015,1,0,16715,1,623,0.727270097,0.272729889,1,623,6923,95,642,623,7220
188,10/8/2015,1,0,16716,1,-106,0.634651244,0.365348771,1,-106,6817,374,75,-200,7020
189,10/9/2015,1,0,16717,1,-197,0.619405419,0.380594596,1,-197,6620,274,188,-200,6820
190,10/12/2015,0,1,16720,0,175,0.489416987,0.510583013,-1,-175,6445,35,276,-200,6620
191,10/13/2015,1,0,16721,1,-89,0.50915581,0.490844235,1,-89,6356,158,168,-89,6531
192,10/14/2015,0,1,16722,0,86,0.453924462,0.546075523,-1,-86,6270,65,175,-86,6445
193,10/15/2015,1,0,16723,1,235,0.686697096,0.313302904,1,235,6505,135,251,235,6680
194,10/16/2015,0,1,16724,0,15,0.409444734,0.59055528,-1,-15,6490,154,47,-15,6665
195,10/19/2015,0,1,16727,0,17,0.354103327,0.645896703,-1,-17,6473,149,64,-17,6648
196,10/20/2015,1,0,16728,1,-51,0.51362589,0.48637414,1,-51,6422,175,50,-51,6597
197,10/22/2015,0,1,16730,0,94,0.325111717,0.674888253,-1,-94,6328,40,128,-94,6503
198,10/23/2015,1,0,16731,1,-104,0.537163228,0.462836817,1,-104,6224,194,5,-104,6399
199,10/26/2015,0,1,16734,0,-372,0.384211689,0.615788311,-1,372,6596,379,4,372,6771
200,10/27/2015,0,1,16735,0,-59,0.313740373,0.686259598,-1,59,6655,235,21,59,6830
201,10/28/2015,0,1,16736,0,-59,0.423426911,0.576573074,-1,59,6714,110,93,59,6889
202,10/29/2015,0,1,16737,0,-136,0.314149722,0.685850263,-1,136,6850,180,49,136,7025
203,10/30/2015,1,0,16738,1,-61,0.522212297,0.477787688,1,-61,6789,137,103,-61,6964
204,11/2/2015,1,0,16741,1,-63,0.65977639,0.34022361,1,-63,6726,190,164,-63,6901
205,11/3/2015,0,1,16742,0,60,0.480815843,0.519184202,-1,-60,6666,20,157,-60,6841
206,11/4/2015,1,0,16743,1,406,0.706757277,0.293242708,1,406,7072,47,639,406,7247
207,11/5/2015,0,1,16744,0,-79,0.380005583,0.619994402,-1,79,7151,127,122,79,7326
208,11/6/2015,0,1,16745,0,-169,0.328407705,0.671592265,-1,169,7320,199,10,169,7495
209,11/9/2015,0,1,16748,0,-48,0.395977214,0.604022771,-1,48,7368,58,295,-200,7295
210,11/10/2015,0,1,16749,0,-58,0.389791161,0.610208809,-1,58,7426,187,37,58,7353
211,11/11/2015,0,1,16750,0,79,0.419354483,0.580645502,-1,-79,7347,29,148,-79,7274
212,11/12/2015,0,1,16751,0,604,0.313740432,0.686259568,-1,-604,6743,0,687,-200,7074
213,11/13/2015,0,1,16752,0,-204,0.483361796,0.516638219,-1,204,6947,266,1,204,7278
214,11/16/2015,0,1,16755,0,158,0.347097218,0.652902812,-1,-158,6789,65,192,-158,7120
215,11/17/2015,0,1,16756,0,19,0.40092048,0.599079549,-1,-19,6770,29,237,-200,6920
216,11/18/2015,0,1,16757,0,-179,0.397531837,0.602468133,-1,179,6949,205,37,179,7099
217,11/19/2015,0,1,16758,0,31,0.440678522,0.559321493,-1,-31,6918,65,122,-31,7068
218,11/20/2015,1,0,16759,1,245,0.55881989,0.44118014,1,245,7163,93,306,245,7313
219,11/23/2015,0,1,16762,0,-105,0.396839157,0.603160799,-1,105,7268,183,17,105,7418
220,11/24/2015,0,1,16763,0,-176,0.433995739,0.566004276,-1,176,7444,295,5,176,7594
221,11/25/2015,0,1,16764,0,4,0.481674507,0.518325478,-1,-4,7440,61,143,-4,7590
222,11/26/2015,0,1,16765,0,-88,0.303761467,0.696238518,-1,88,7528,178,442,-200,7390
223,11/27/2015,0,1,16766,0,-363,0.373919427,0.626080573,-1,363,7891,384,18,363,7753
224,11/30/2015,0,1,16769,0,-146,0.370849326,0.629150659,-1,146,8037,199,112,146,7899
225,12/1/2015,0,1,16770,0,184,0.476017803,0.523982167,-1,-184,7853,106,285,-200,7699
226,12/2/2015,1,0,16771,1,-17,0.557586998,0.442413032,1,-17,7836,138,76,-17,7682
227,12/3/2015,0,1,16772,0,107,0.466389135,0.533610851,-1,-107,7729,55,174,-107,7575
228,12/4/2015,0,1,16773,0,39,0.342106223,0.657893807,-1,-39,7690,66,117,-39,7536
229,12/7/2015,0,1,16776,0,-33,0.461481631,0.538518399,-1,33,7723,100,75,33,7569
230,12/8/2015,0,1,16777,0,-253,0.347027332,0.652972668,-1,253,7976,367,18,253,7822
231,12/9/2015,1,0,16778,1,38,0.632521033,0.367478997,1,38,8014,35,109,38,7860
232,12/10/2015,0,1,16779,0,-43,0.470234334,0.529765725,-1,43,8057,48,199,43,7903
233,12/11/2015,0,1,16780,0,-303,0.379988581,0.620011419,-1,303,8360,305,53,303,8206
234,12/14/2015,1,0,16783,1,252,0.642679691,0.357320249,1,252,8612,73,316,252,8458
235,12/15/2015,0,1,16784,0,66,0.283710837,0.716289163,-1,-66,8546,53,144,-66,8392
236,12/16/2015,1,0,16785,1,207,0.506910264,0.493089721,1,207,8753,42,240,207,8599
237,12/17/2015,0,1,16786,0,46,0.371707797,0.628292203,-1,-46,8707,45,231,-200,8399
238,12/18/2015,0,1,16787,0,147,0.48615548,0.51384455,-1,-147,8560,50,321,-200,8199
239,12/21/2015,1,0,16790,1,164,0.563499957,0.436500058,1,164,8724,56,232,164,8363
240,12/22/2015,0,1,16791,0,6,0.352256849,0.647743195,-1,-6,8718,107,30,-6,8357
241,12/23/2015,0,1,16792,0,221,0.436262786,0.563737214,-1,-221,8497,59,244,-200,8157
242,12/24/2015,0,1,16793,0,-123,0.364228815,0.635771215,-1,123,8620,136,31,123,8280
243,12/28/2015,1,0,16797,1,-250,0.643777639,0.356222391,1,-250,8370,280,74,-200,8080
244,12/29/2015,0,1,16798,0,155,0.459284663,0.540715277,-1,-155,8215,59,157,-155,7925
245,12/30/2015,0,1,16799,0,-212,0.301549017,0.698450983,-1,212,8427,227,26,212,8137
246,12/31/2015,1,0,16800,1,60,0.657074183,0.342925787,1,60,8487,32,135,60,8197
0,1/4/2016,1,0,16804,1,-684,0.671189159,0.328810871,1,-684,-684,693,50,-200,-200
1,1/5/2016,1,0,16805,1,-27,0.732971877,0.267028093,1,-27,-711,130,242,-27,-227
2,1/6/2016,0,1,16806,0,-348,0.376311377,0.623688638,-1,348,-363,354,41,348,121
3,1/7/2016,1,0,16807,1,-438,0.68764773,0.31235227,1,-438,-801,528,48,-200,-79
4,1/8/2016,1,0,16808,1,-54,0.689293563,0.310706437,1,-54,-855,171,167,-54,-133
5,1/11/2016,0,1,16811,0,43,0.497270763,0.502729192,-1,-43,-898,80,166,-43,-176
6,1/12/2016,0,1,16812,0,-326,0.340034619,0.659965336,-1,326,-572,367,89,326,150
7,1/13/2016,1,0,16813,1,-16,0.525764912,0.474235073,1,-16,-588,257,154,-200,-50
8,1/14/2016,1,0,16814,1,255,0.554672122,0.445327938,1,255,-333,87,338,255,205
9,1/15/2016,1,0,16815,1,-327,0.722615808,0.277384192,1,-327,-660,341,32,-200,5
10,1/18/2016,1,0,16818,1,101,0.723274767,0.276725277,1,101,-559,28,272,101,106
11,1/19/2016,1,0,16819,1,399,0.645709395,0.35429059,1,399,-160,65,425,399,505
12,1/20/2016,0,1,16820,0,-433,0.307730004,0.692269951,-1,433,273,518,63,433,938
13,1/21/2016,1,0,16821,1,-304,0.740464836,0.259535179,1,-304,-31,525,205,-200,738
14,1/22/2016,1,0,16822,1,61,0.690924644,0.30907537,1,61,30,277,125,-200,538
15,1/25/2016,0,1,16825,0,-52,0.277547464,0.722452521,-1,52,82,61,215,-200,338
16,1/26/2016,1,0,16826,1,-104,0.632154852,0.367845133,1,-104,-22,220,81,-200,138
17,1/27/2016,1,0,16827,1,-256,0.699498028,0.300501958,1,-256,-278,344,13,-200,-62
18,1/28/2016,1,0,16828,1,61,0.734579414,0.265420571,1,61,-217,21,197,61,-1
19,1/29/2016,0,1,16829,0,508,0.395079777,0.604920238,-1,-508,-725,184,523,-200,-201
20,2/1/2016,1,0,16832,1,-216,0.722290188,0.277709797,1,-216,-941,279,30,-200,-401
21,2/2/2016,1,0,16833,1,8,0.535565674,0.464434266,1,8,-933,90,175,8,-393
22,2/3/2016,1,0,16834,1,-22,0.635397315,0.364602715,1,-22,-955,267,29,-200,-593
23,2/4/2016,1,0,16835,1,-32,0.707875401,0.292124614,1,-32,-987,73,169,-32,-625
24,2/5/2016,1,0,16836,1,125,0.737738937,0.262261093,1,125,-862,2,221,125,-500
25,2/11/2016,1,0,16842,1,-22,0.710120469,0.289879546,1,-22,-884,130,187,-22,-522
26,2/12/2016,1,0,16843,1,93,0.73841092,0.26158911,1,93,-791,62,205,93,-429
27,2/15/2016,1,0,16846,1,187,0.639818996,0.360181019,1,187,-604,27,284,187,-242
28,2/16/2016,1,0,16847,1,151,0.582689106,0.417310879,1,151,-453,98,282,151,-91
29,2/17/2016,0,1,16848,0,-334,0.280902654,0.719097346,-1,334,-119,355,57,334,243
30,2/18/2016,1,0,16849,1,-93,0.607596308,0.392403692,1,-93,-212,130,64,-93,150
31,2/19/2016,0,1,16850,0,100,0.374410242,0.625589758,-1,-100,-312,42,107,-100,50
32,2/22/2016,1,0,16853,1,127,0.677518308,0.322481737,1,127,-185,9,197,127,177
33,2/23/2016,1,0,16854,1,-115,0.607005626,0.392994419,1,-115,-300,219,26,-200,-23
34,2/24/2016,1,0,16855,1,-220,0.562175423,0.437824607,1,-220,-520,298,3,-200,-223
35,2/25/2016,1,0,16856,1,-263,0.712127447,0.287872568,1,-263,-783,325,34,-200,-423
36,2/26/2016,1,0,16857,1,45,0.505906165,0.49409385,1,45,-738,28,96,45,-378
37,2/29/2016,0,1,16860,0,-288,0.315093368,0.684906632,-1,288,-450,385,0,288,-90
38,3/1/2016,1,0,16861,1,157,0.580305636,0.419694364,1,157,-293,174,158,157,67
39,3/2/2016,0,1,16862,0,245,0.478699327,0.521300644,-1,-245,-538,11,350,-200,-133
40,3/3/2016,1,0,16863,1,-138,0.730049253,0.269950807,1,-138,-676,241,64,-200,-333
41,3/4/2016,1,0,16864,1,100,0.721710145,0.278289855,1,100,-576,75,184,100,-233
42,3/7/2016,0,1,16867,0,-132,0.460756496,0.539243519,-1,132,-444,211,24,132,-101
43,3/8/2016,1,0,16868,1,-152,0.589476973,0.410522997,1,-152,-596,222,31,-200,-301
44,3/9/2016,1,0,16869,1,106,0.527548254,0.472451746,1,106,-490,71,116,106,-195
45,3/10/2016,0,1,16870,0,-36,0.359287277,0.640712708,-1,36,-454,143,155,36,-159
46,3/11/2016,1,0,16871,1,263,0.520970136,0.479029849,1,263,-191,137,273,263,104
47,3/14/2016,1,0,16874,1,23,0.556271702,0.443728283,1,23,-168,79,104,23,127
48,3/15/2016,0,1,16875,0,-52,0.30507791,0.69492209,-1,52,-116,90,29,52,179
49,3/16/2016,0,1,16876,0,5,0.307089925,0.692910075,-1,-5,-121,131,131,-5,174
50,3/17/2016,1,0,16877,1,-101,0.751585007,0.248415001,1,-101,-222,139,62,-101,73
51,3/18/2016,1,0,16878,1,107,0.692943484,0.307056516,1,107,-115,2,209,107,180
52,3/21/2016,1,0,16881,1,-105,0.537018895,0.46298112,1,-105,-220,169,4,-105,75
53,3/22/2016,0,1,16882,0,-138,0.460275263,0.539724767,-1,138,-82,164,30,138,213
54,3/23/2016,0,1,16883,0,2,0.472442344,0.527557671,-1,-2,-84,126,45,-2,211
55,3/24/2016,0,1,16884,0,-94,0.39082928,0.609170735,-1,94,10,150,94,94,305
56,3/29/2016,1,0,16889,1,-1,0.576528937,0.423471019,1,-1,9,93,76,-1,304
57,3/30/2016,1,0,16890,1,190,0.740377247,0.259622708,1,190,199,15,225,190,494
58,3/31/2016,1,0,16891,1,-73,0.620178938,0.379821062,1,-73,126,177,11,-73,421
59,4/1/2016,1,0,16892,1,-338,0.660202324,0.339797646,1,-338,-212,352,30,-200,221
60,4/5/2016,0,1,16896,0,-259,0.296817422,0.703182578,-1,259,47,297,0,259,480
61,4/6/2016,1,0,16897,1,87,0.724295735,0.27570422,1,87,134,14,173,87,567
62,4/7/2016,0,1,16898,0,-40,0.481004968,0.518995047,-1,40,174,146,80,40,607
63,4/8/2016,1,0,16899,1,409,0.650899172,0.349100798,1,409,583,13,413,409,1016
64,4/11/2016,0,1,16902,0,300,0.402278528,0.597721457,-1,-300,283,66,341,-200,816
65,4/12/2016,0,1,16903,0,24,0.413662627,0.586337358,-1,-24,259,49,122,-24,792
66,4/13/2016,1,0,16904,1,507,0.514965087,0.485034928,1,507,766,18,514,507,1299
67,4/14/2016,0,1,16905,0,-90,0.482564211,0.517435759,-1,90,856,135,113,90,1389
68,4/15/2016,0,1,16906,0,-78,0.284038842,0.715961128,-1,78,934,162,31,78,1467
69,4/18/2016,1,0,16909,1,79,0.669495493,0.330504447,1,79,1013,67,106,79,1546
70,4/19/2016,1,0,16910,1,-17,0.530330062,0.469669923,1,-17,996,174,74,-17,1529
71,4/20/2016,1,0,16911,1,-227,0.671161443,0.328838557,1,-227,769,376,5,-200,1329
72,4/21/2016,0,1,16912,0,145,0.498032317,0.501967713,-1,-145,624,98,215,-200,1129
73,4/22/2016,0,1,16913,0,103,0.363622993,0.636377037,-1,-103,521,47,122,-103,1026
74,4/25/2016,0,1,16916,0,-90,0.461674064,0.538325936,-1,90,611,115,68,90,1116
75,4/26/2016,0,1,16917,0,63,0.339458689,0.660541326,-1,-63,548,239,107,-63,1053
76,4/27/2016,0,1,16918,0,-64,0.416099101,0.583900899,-1,64,612,71,96,64,1117
77,4/28/2016,1,0,16919,1,20,0.728596985,0.271403015,1,20,632,87,202,20,1137
78,4/29/2016,1,0,16920,1,-224,0.725597024,0.274403021,1,-224,408,243,57,-200,937
79,5/3/2016,0,1,16924,0,-416,0.330690816,0.669309139,-1,416,824,458,27,416,1353
80,5/4/2016,1,0,16925,1,-62,0.606825888,0.393174082,1,-62,762,88,99,-62,1291
81,5/5/2016,1,0,16926,1,73,0.575118124,0.424881876,1,73,835,16,180,73,1364
82,5/6/2016,0,1,16927,0,-176,0.343767107,0.656232893,-1,176,1011,264,95,176,1540
83,5/9/2016,1,0,16930,1,-112,0.686880141,0.313119888,1,-112,899,193,46,-112,1428
84,5/10/2016,0,1,16931,0,230,0.41550222,0.58449775,-1,-230,669,77,299,-200,1228
85,5/11/2016,1,0,16932,1,-342,0.677114099,0.322885856,1,-342,327,377,13,-200,1028
86,5/12/2016,1,0,16933,1,-131,0.586631179,0.413368821,1,-131,196,204,75,-200,828
87,5/13/2016,0,1,16934,0,-96,0.304898977,0.695100993,-1,96,292,252,44,96,924
88,5/16/2016,1,0,16937,1,294,0.558987111,0.441012904,1,294,586,6,358,294,1218
89,5/17/2016,0,1,16938,0,95,0.441167086,0.558832973,-1,-95,491,130,165,-95,1123
90,5/18/2016,1,0,16939,1,-82,0.652290255,0.34770976,1,-82,409,130,54,-82,1041
91,5/19/2016,0,1,16940,0,-72,0.268819898,0.731180072,-1,72,481,116,53,72,1113
92,5/20/2016,1,0,16941,1,250,0.605323911,0.394676074,1,250,731,26,343,250,1363
93,5/23/2016,0,1,16944,0,40,0.387181729,0.612818301,-1,-40,691,86,144,-40,1323
94,5/24/2016,1,0,16945,1,73,0.62662822,0.373371735,1,73,764,99,94,73,1396
95,5/25/2016,0,1,16946,0,260,0.328372449,0.671627522,-1,-260,504,3,309,-200,1196
96,5/26/2016,1,0,16947,1,-5,0.634559274,0.365440711,1,-5,499,142,17,-5,1191
97,5/27/2016,1,0,16948,1,139,0.572257549,0.427742481,1,139,638,163,205,139,1330
98,5/30/2016,0,1,16951,0,57,0.366190657,0.633809358,-1,-57,581,128,124,-57,1273
99,5/31/2016,1,0,16952,1,173,0.570490181,0.429509833,1,173,754,7,418,173,1446
100,6/1/2016,0,1,16953,0,84,0.315132126,0.684867889,-1,-84,670,28,197,-84,1362
101,6/2/2016,1,0,16954,1,106,0.638408899,0.361591101,1,106,776,75,142,106,1468
102,6/3/2016,1,0,16955,1,-7,0.723137349,0.276862606,1,-7,769,61,117,-7,1461
103,6/6/2016,1,0,16958,1,46,0.714230001,0.285769999,1,46,815,143,81,46,1507
104,6/7/2016,1,0,16959,1,126,0.656144232,0.343855754,1,126,941,43,164,126,1633
105,6/8/2016,1,0,16960,1,18,0.657701433,0.342298582,1,18,959,104,61,18,1651
106,6/10/2016,0,1,16962,0,-269,0.354809746,0.645190269,-1,269,1228,297,32,269,1920
107,6/13/2016,0,1,16965,0,-141,0.463680401,0.536319673,-1,141,1369,289,28,141,2061
108,6/14/2016,1,0,16966,1,-133,0.539754122,0.460245892,1,-133,1236,150,49,-133,1928
109,6/15/2016,0,1,16967,0,319,0.41091013,0.589089841,-1,-319,917,50,423,-200,1728
110,6/16/2016,1,0,16968,1,-270,0.718700111,0.281299829,1,-270,647,356,23,-200,1528
111,6/17/2016,1,0,16969,1,-149,0.632401705,0.367598265,1,-149,498,205,28,-200,1328
112,6/20/2016,1,0,16972,1,86,0.650465548,0.349534422,1,86,584,138,166,86,1414
113,6/21/2016,0,1,16973,0,115,0.374301344,0.625698656,-1,-115,469,30,159,-115,1299
114,6/22/2016,0,1,16974,0,253,0.411715284,0.588284761,-1,-253,216,70,298,-200,1099
115,6/23/2016,0,1,16975,0,53,0.423515633,0.576484382,-1,-53,163,153,63,-53,1046
116,6/24/2016,1,0,16976,1,-397,0.530096769,0.469903201,1,-397,-234,989,446,-200,846
117,6/27/2016,1,0,16979,1,212,0.742020577,0.257979393,1,212,-22,14,375,212,1058
118,6/28/2016,1,0,16980,1,386,0.526562721,0.473437294,1,386,364,8,386,386,1444
119,6/29/2016,1,0,16981,1,134,0.663631111,0.336368904,1,134,498,37,160,134,1578
120,6/30/2016,0,1,16982,0,219,0.485611871,0.514388084,-1,-219,279,112,230,-200,1378
121,7/4/2016,1,0,16986,1,49,0.738622934,0.261377081,1,49,328,146,206,49,1427
122,7/5/2016,1,0,16987,1,-188,0.619256824,0.380743176,1,-188,140,195,52,-188,1239
123,7/6/2016,1,0,16988,1,-46,0.576816827,0.423183143,1,-46,94,278,21,-200,1039
124,7/7/2016,1,0,16989,1,33,0.675741196,0.324258819,1,33,127,123,75,33,1072
125,7/8/2016,0,1,16990,0,-41,0.350098476,0.649901539,-1,41,168,152,37,41,1113
126,7/11/2016,1,0,16993,1,-93,0.67942518,0.320574835,1,-93,75,133,67,-93,1020
127,7/12/2016,0,1,16994,0,250,0.432301253,0.567698747,-1,-250,-175,55,265,-200,820
128,7/13/2016,0,1,16995,0,-104,0.387099266,0.612900764,-1,104,-71,127,45,104,924
129,7/14/2016,1,0,16996,1,270,0.54666993,0.45333007,1,270,199,57,281,270,1194
130,7/15/2016,0,1,16997,0,131,0.41592744,0.58407253,-1,-131,68,70,173,-131,1063
131,7/18/2016,0,1,17000,0,95,0.493447065,0.506552905,-1,-95,-27,25,190,-95,968
132,7/19/2016,1,0,17001,1,-72,0.671792924,0.328207076,1,-72,-99,107,15,-72,896
133,7/20/2016,0,1,17002,0,242,0.325881451,0.674118608,-1,-242,-341,22,280,-200,696
134,7/21/2016,0,1,17003,0,73,0.446706042,0.553293973,-1,-73,-414,24,208,-200,496
135,7/22/2016,1,0,17004,1,61,0.628610671,0.371389329,1,61,-353,72,68,61,557
136,7/25/2016,0,1,17007,0,-61,0.391177908,0.608822078,-1,61,-292,207,2,61,618
137,7/26/2016,0,1,17008,0,220,0.306430295,0.69356969,-1,-220,-512,20,433,-200,418
138,7/27/2016,1,0,17009,1,-19,0.577933937,0.422066033,1,-19,-531,178,99,-19,399
139,7/28/2016,1,0,17010,1,-6,0.519400924,0.480599105,1,-6,-537,80,48,-6,393
140,7/29/2016,1,0,17011,1,-235,0.618067086,0.381932914,1,-235,-772,248,128,-200,193
141,8/1/2016,1,0,17014,1,199,0.514224797,0.485775232,1,199,-573,0,324,199,392
142,8/3/2016,0,1,17016,0,-101,0.306589365,0.693410665,-1,101,-472,110,16,101,493
143,8/4/2016,1,0,17017,1,-56,0.71314916,0.28685081,1,-56,-528,136,9,-56,437
144,8/5/2016,1,0,17018,1,222,0.645027608,0.354972392,1,222,-306,21,270,222,659
145,8/8/2016,0,1,17021,0,142,0.346469775,0.65353021,-1,-142,-448,109,173,-142,517
146,8/9/2016,0,1,17022,0,41,0.492721125,0.507278875,-1,-41,-489,19,81,-41,476
147,8/10/2016,0,1,17023,0,-62,0.359217018,0.640782952,-1,62,-427,137,118,62,538
148,8/11/2016,0,1,17024,0,153,0.320697308,0.679302752,-1,-153,-580,85,280,-200,338
149,8/12/2016,0,1,17025,0,27,0.431665599,0.56833443,-1,-27,-607,49,87,-27,311
150,8/15/2016,0,1,17028,0,162,0.446973309,0.553026646,-1,-162,-769,63,216,-200,111
151,8/16/2016,0,1,17029,0,-81,0.471588552,0.528411418,-1,81,-688,169,56,81,192
152,8/17/2016,1,0,17030,1,-233,0.539349198,0.460650772,1,-233,-921,239,58,-200,-8
153,8/18/2016,1,0,17031,1,150,0.651406169,0.348593846,1,150,-771,1,300,150,142
154,8/19/2016,1,0,17032,1,-188,0.643722653,0.356277362,1,-188,-959,243,48,-200,-58
155,8/22/2016,0,1,17035,0,-26,0.474007055,0.52599293,-1,26,-933,217,29,26,-32
156,8/23/2016,1,0,17036,1,121,0.532261491,0.467738509,1,121,-812,65,130,121,89
157,8/24/2016,0,1,17037,0,-222,0.495942995,0.504057035,-1,222,-590,355,10,222,311
158,8/25/2016,0,1,17038,0,5,0.348146781,0.651853234,-1,-5,-595,57,120,-5,306
159,8/26/2016,1,0,17039,1,94,0.613774151,0.386225849,1,94,-501,25,176,94,400
160,8/29/2016,0,1,17042,0,-61,0.312235743,0.687764227,-1,61,-440,141,41,61,461
161,8/30/2016,1,0,17043,1,106,0.597195953,0.402804032,1,106,-334,0,148,106,567
162,8/31/2016,1,0,17044,1,-16,0.50355652,0.496443465,1,-16,-350,99,28,-16,551
163,9/1/2016,0,1,17045,0,299,0.38193801,0.61806196,-1,-299,-649,113,300,-200,351
164,9/2/2016,0,1,17046,0,110,0.499611542,0.500388533,-1,-110,-759,25,180,-110,241
165,9/5/2016,0,1,17049,0,158,0.45444417,0.54555583,-1,-158,-917,21,203,-200,41
166,9/6/2016,1,0,17050,1,147,0.510306865,0.48969315,1,147,-770,45,169,147,188
167,9/7/2016,1,0,17051,1,-70,0.691384315,0.30861567,1,-70,-840,93,38,-70,118
168,9/8/2016,1,0,17052,1,194,0.601202667,0.398797318,1,194,-646,50,208,194,312
169,9/9/2016,0,1,17053,0,230,0.488860488,0.511139542,-1,-230,-876,17,520,-200,112
170,9/12/2016,0,1,17056,0,-290,0.312655032,0.687344968,-1,290,-586,296,55,290,402
171,9/13/2016,1,0,17057,1,-298,0.617828935,0.382171065,1,-298,-884,373,89,-200,202
172,9/14/2016,0,1,17058,0,102,0.317361712,0.682638288,-1,-102,-986,10,230,-200,2
173,9/15/2016,1,0,17059,1,133,0.665177763,0.334822252,1,133,-853,31,259,133,135
174,9/19/2016,1,0,17063,1,43,0.630497634,0.369502366,1,43,-810,83,134,43,178
175,9/20/2016,0,1,17064,0,40,0.334741876,0.66525808,-1,-40,-850,80,76,-40,138
176,9/21/2016,0,1,17065,0,132,0.481771365,0.518228561,-1,-132,-982,102,205,-200,-62
177,9/22/2016,1,0,17066,1,-66,0.646850854,0.353149071,1,-66,-1048,172,218,-66,-128
178,9/23/2016,1,0,17067,1,-214,0.558283389,0.441716596,1,-214,-1262,266,14,-200,-328
179,9/26/2016,1,0,17070,1,-256,0.525312275,0.474687681,1,-256,-1518,282,8,-200,-528
180,9/27/2016,1,0,17071,1,440,0.560325176,0.43967481,1,440,-1078,0,484,440,-88
181,9/28/2016,0,1,17072,0,140,0.405239105,0.594760925,-1,-140,-1218,137,157,-140,-228
182,9/29/2016,1,0,17073,1,-78,0.698491514,0.301508486,1,-78,-1296,103,68,-78,-306
183,9/30/2016,0,1,17074,0,-191,0.413152844,0.586847126,-1,191,-1105,304,7,191,-115
184,10/3/2016,0,1,17077,0,-12,0.363564909,0.636435062,-1,12,-1093,101,136,12,-103
185,10/4/2016,1,0,17078,1,84,0.632765174,0.367234811,1,84,-1009,97,90,84,-19
186,10/5/2016,0,1,17079,0,200,0.273679167,0.726320803,-1,-200,-1209,42,293,-200,-219
187,10/6/2016,1,0,17080,1,86,0.52616477,0.473835215,1,86,-1123,55,162,86,-133
188,10/7/2016,1,0,17081,1,-70,0.523996592,0.476003408,1,-70,-1193,149,20,-70,-203
189,10/11/2016,1,0,17085,1,-596,0.634263784,0.365736216,1,-596,-1789,640,56,-200,-403
190,10/12/2016,0,1,17086,0,18,0.300394788,0.699605227,-1,-18,-1807,144,37,-18,-421
191,10/13/2016,0,1,17087,0,-477,0.373309463,0.626690537,-1,477,-1330,478,0,477,56
192,10/14/2016,1,0,17088,1,129,0.667662591,0.332337365,1,129,-1201,29,234,129,185
193,10/17/2016,0,1,17091,0,-143,0.354176819,0.645823181,-1,143,-1058,230,39,143,328
194,10/18/2016,1,0,17092,1,247,0.62431702,0.37568298,1,247,-811,12,281,247,575
195,10/19/2016,0,1,17093,0,-37,0.400159344,0.599840671,-1,37,-774,129,115,37,612
196,10/20/2016,1,0,17094,1,10,0.51664862,0.48335129,1,10,-764,40,113,10,622
197,10/24/2016,1,0,17098,1,258,0.622927845,0.377072155,1,258,-506,137,287,258,880
198,10/25/2016,0,1,17099,0,45,0.294695586,0.705304414,-1,-45,-551,72,84,-45,835
199,10/26/2016,0,1,17100,0,-125,0.490723267,0.509276748,-1,125,-426,151,26,125,960
200,10/27/2016,0,1,17101,0,-171,0.345732585,0.65426746,-1,171,-255,335,33,171,1131
201,10/28/2016,0,1,17102,0,-91,0.281001642,0.718998402,-1,91,-164,100,66,91,1222
202,10/31/2016,1,0,17105,1,117,0.517270595,0.482729375,1,117,-47,81,266,117,1339
203,11/1/2016,0,1,17106,0,305,0.438576862,0.561423153,-1,-305,-352,12,366,-200,1139
204,11/2/2016,0,1,17107,0,-93,0.31389226,0.686107695,-1,93,-259,116,55,93,1232
205,11/3/2016,0,1,17108,0,-19,0.369085565,0.63091445,-1,19,-240,87,119,19,1251
206,11/4/2016,0,1,17109,0,13,0.279457986,0.720542014,-1,-13,-253,19,168,-13,1238
207,11/7/2016,1,0,17112,1,141,0.513632536,0.486367434,1,141,-112,22,230,141,1379
208,11/8/2016,0,1,17113,0,6,0.380885452,0.619114518,-1,-6,-118,123,75,-6,1373
209,11/9/2016,1,0,17114,1,-747,0.543018758,0.456981212,1,-747,-865,1246,2,-200,1173
210,11/10/2016,0,1,17115,0,79,0.353025422,0.646974564,-1,-79,-944,78,87,-79,1094
211,11/11/2016,0,1,17116,0,-161,0.257774428,0.742225558,-1,161,-783,218,56,161,1255
212,11/14/2016,1,0,17119,1,-80,0.519949198,0.480050772,1,-80,-863,258,19,-200,1055
213,11/15/2016,0,1,17120,0,78,0.291326344,0.708673656,-1,-78,-941,25,162,-78,977
214,11/16/2016,1,0,17121,1,-232,0.532736242,0.467263773,1,-232,-1173,256,40,-200,777
215,11/17/2016,0,1,17122,0,67,0.464466467,0.535533518,-1,-67,-1240,71,185,-67,710
216,11/18/2016,0,1,17123,0,81,0.279183879,0.720816135,-1,-81,-1321,135,114,-81,629
217,11/21/2016,0,1,17126,0,50,0.376093298,0.623906672,-1,-50,-1371,90,190,-50,579
218,11/22/2016,1,0,17127,1,220,0.575563908,0.424436107,1,220,-1151,7,283,220,799
219,11/23/2016,0,1,17128,0,51,0.48393254,0.516067445,-1,-51,-1202,39,154,-51,748
220,11/24/2016,1,0,17129,1,-2,0.578587532,0.421412408,1,-2,-1204,140,45,-2,746
221,11/25/2016,0,1,17130,0,103,0.414046884,0.585953116,-1,-103,-1307,67,161,-103,643
222,11/28/2016,1,0,17133,1,84,0.529603362,0.470396623,1,84,-1223,9,278,84,727
223,11/29/2016,0,1,17134,0,55,0.353966817,0.646033198,-1,-55,-1278,45,95,-55,672
224,11/30/2016,1,0,17135,1,2,0.510162622,0.489837408,1,2,-1276,44,109,2,674
225,12/1/2016,1,0,17136,1,-7,0.535568625,0.464431375,1,-7,-1283,48,118,-7,667
226,12/2/2016,0,1,17137,0,-175,0.285119087,0.714880943,-1,175,-1108,218,16,175,842
227,12/5/2016,1,0,17140,1,0,0.597786337,0.402213693,1,0,-1108,205,70,-200,642
228,12/6/2016,1,0,17141,1,31,0.634093761,0.365906239,1,31,-1077,23,122,31,673
229,12/7/2016,1,0,17142,1,-6,0.670578033,0.329421997,1,-6,-1083,70,52,-6,667
230,12/8/2016,0,1,17143,0,-205,0.45847863,0.54152137,-1,205,-878,232,104,205,872
231,12/9/2016,0,1,17144,0,-106,0.385604307,0.614395708,-1,106,-772,171,25,106,978
232,12/12/2016,0,1,17147,0,-485,0.269115061,0.73088491,-1,485,-287,518,9,485,1463
233,12/13/2016,0,1,17148,0,11,0.445443124,0.554556876,-1,-11,-298,164,27,-11,1452
234,12/14/2016,0,1,17149,0,-108,0.296433881,0.703566104,-1,108,-190,145,53,108,1560
235,12/15/2016,0,1,17150,0,-214,0.290896043,0.709103942,-1,214,24,328,9,214,1774
236,12/16/2016,0,1,17151,0,-32,0.304184303,0.695815653,-1,32,56,61,153,32,1806
237,12/19/2016,0,1,17154,0,-92,0.345104352,0.654895663,-1,92,148,167,59,92,1898
238,12/20/2016,0,1,17155,0,-80,0.39623715,0.603762835,-1,80,228,122,91,80,1978
239,12/21/2016,1,0,17156,1,100,0.538898051,0.461101964,1,100,328,7,189,100,2078
240,12/22/2016,1,0,17157,1,-123,0.562667221,0.437332749,1,-123,205,147,81,-123,1955
241,12/23/2016,1,0,17158,1,-14,0.634814441,0.365185574,1,-14,191,75,42,-14,1941
242,12/28/2016,1,0,17163,1,221,0.57314983,0.426850125,1,221,412,18,290,221,2162
243,12/29/2016,1,0,17164,1,155,0.534730613,0.465269372,1,155,567,71,174,155,2317
244,12/30/2016,1,0,17165,1,112,0.598152876,0.401847139,1,112,679,37,206,112,2429
0,1/3/2017,0,1,17169,0,205,0.441282377,0.558717608,-1,-205,-205,57,275,-200,-200
1,1/4/2017,1,0,17170,1,-76,0.523772836,0.476227194,1,-76,-281,117,58,-76,-276
2,1/5/2017,1,0,17171,1,227,0.501670599,0.498329341,1,227,-54,50,237,227,-49
3,1/6/2017,1,0,17172,1,-9,0.668786824,0.331213176,1,-9,-63,76,85,-9,-58
4,1/9/2017,0,1,17175,0,-17,0.404878482,0.595121503,-1,17,-46,119,47,17,-41
5,1/10/2017,0,1,17176,0,202,0.479776621,0.520223379,-1,-202,-248,20,207,-200,-241
6,1/11/2017,1,0,17177,1,174,0.534068316,0.465931654,1,174,-74,21,178,174,-67
7,1/12/2017,1,0,17178,1,-89,0.645675689,0.354324311,1,-89,-163,185,41,-89,-156
8,1/13/2017,1,0,17179,1,40,0.53117308,0.468826935,1,40,-123,42,69,40,-116
9,1/16/2017,0,1,17182,0,-108,0.398381397,0.601618618,-1,108,-15,201,40,108,-8
10,1/17/2017,0,1,17183,0,4,0.445594937,0.554405063,-1,-4,-19,119,25,-4,-12
11,1/18/2017,1,0,17184,1,222,0.63959232,0.360407665,1,222,203,20,286,222,210
12,1/19/2017,0,1,17185,0,-31,0.40399383,0.596006155,-1,31,234,127,6,31,241
13,1/20/2017,1,0,17186,1,-62,0.521805823,0.478194147,1,-62,172,126,26,-62,179
14,1/23/2017,0,1,17189,0,-53,0.445326373,0.554673642,-1,53,225,97,154,53,232
15,1/24/2017,1,0,17190,1,-40,0.66707167,0.3329283,1,-40,185,58,28,-40,192
16,1/25/2017,0,1,17191,0,-23,0.454078898,0.545921147,-1,23,208,127,8,23,215
17,1/26/2017,0,1,17192,0,165,0.441809863,0.558190137,-1,-165,43,42,189,-165,50
18,1/27/2017,0,1,17193,0,82,0.435929775,0.564070195,-1,-82,-39,14,109,-82,-32
19,2/1/2017,1,0,17198,1,119,0.546805501,0.453194529,1,119,80,172,132,119,87
20,2/2/2017,0,1,17199,0,-143,0.36910969,0.63089031,-1,143,223,222,134,143,230
21,2/3/2017,1,0,17200,1,-172,0.575831324,0.424168676,1,-172,51,284,7,-200,30
22,2/6/2017,0,1,17203,0,108,0.402831778,0.597168237,-1,-108,-57,71,156,-108,-78
23,2/7/2017,1,0,17204,1,66,0.594432086,0.405567884,1,66,9,28,147,66,-12
24,2/8/2017,0,1,17205,0,178,0.384300336,0.615699679,-1,-178,-169,157,225,-200,-212
25,2/9/2017,1,0,17206,1,37,0.599756002,0.400243983,1,37,-132,14,157,37,-175
26,2/10/2017,1,0,17207,1,-63,0.50431858,0.495681435,1,-63,-195,96,76,-63,-238
27,2/13/2017,1,0,17210,1,65,0.578845352,0.421154618,1,65,-130,18,121,65,-173
28,2/14/2017,0,1,17211,0,4,0.402586699,0.597413272,-1,-4,-134,90,25,-4,-177
29,2/15/2017,0,1,17212,0,261,0.414446041,0.585553944,-1,-261,-395,15,290,-200,-377
30,2/16/2017,0,1,17213,0,16,0.455278337,0.544721693,-1,-16,-411,109,48,-16,-393
31,2/17/2017,1,0,17214,1,-41,0.539668322,0.460331708,1,-41,-452,113,40,-41,-434
32,2/20/2017,0,1,17217,0,147,0.409289852,0.590710163,-1,-147,-599,21,195,-147,-581
33,2/21/2017,0,1,17218,0,-207,0.493178219,0.506821781,-1,207,-392,219,58,207,-374
34,2/22/2017,1,0,17219,1,133,0.512319237,0.487680748,1,133,-259,33,133,133,-241
35,2/23/2017,1,0,17220,1,76,0.550777912,0.449222088,1,76,-183,28,154,76,-165
36,2/24/2017,0,1,17221,0,-123,0.370404378,0.629595667,-1,123,-60,163,8,123,-42
37,2/27/2017,1,0,17224,1,13,0.591131955,0.408868045,1,13,-47,76,129,13,-29
38,2/28/2017,0,1,17225,0,-185,0.404669076,0.595330924,-1,185,138,202,84,185,156
39,3/1/2017,0,1,17226,0,-8,0.437611833,0.562388211,-1,8,146,64,53,8,164
40,3/2/2017,0,1,17227,0,-401,0.332321599,0.667678356,-1,401,547,402,47,401,565
41,3/3/2017,0,1,17228,0,-88,0.323239043,0.676760972,-1,88,635,152,2,88,653
42,3/6/2017,1,0,17231,1,-23,0.635494381,0.364505589,1,-23,612,50,84,-23,630
43,3/7/2017,0,1,17232,0,51,0.458947405,0.54105258,-1,-51,561,35,93,-51,579
44,3/8/2017,0,1,17233,0,124,0.392534733,0.607465267,-1,-124,437,119,146,-124,455
45,3/9/2017,0,1,17234,0,-177,0.312431827,0.687568188,-1,177,614,246,0,177,632
46,3/10/2017,0,1,17235,0,58,0.328765586,0.671234369,-1,-58,556,75,92,-58,574
47,3/13/2017,0,1,17238,0,201,0.434631214,0.565368861,-1,-201,355,45,249,-200,374
48,3/14/2017,0,1,17239,0,-33,0.441176385,0.558823615,-1,33,388,66,88,33,407
49,3/15/2017,1,0,17240,1,46,0.528520763,0.471479222,1,46,434,113,101,46,453
50,3/16/2017,1,0,17241,1,385,0.70719856,0.292801455,1,385,819,0,405,385,838
51,3/17/2017,0,1,17242,0,-48,0.46619916,0.53380084,-1,48,867,90,64,48,886
52,3/20/2017,0,1,17245,0,192,0.475432873,0.524567127,-1,-192,675,55,200,-200,686
53,3/21/2017,1,0,17246,1,56,0.678293079,0.321706876,1,56,731,45,124,56,742
54,3/22/2017,0,1,17247,0,-2,0.368469834,0.631530225,-1,2,733,77,91,2,744
55,3/23/2017,1,0,17248,1,-56,0.612488687,0.387511328,1,-56,677,112,59,-56,688
56,3/24/2017,0,1,17249,0,-49,0.437961817,0.562038183,-1,49,726,149,19,49,737
57,3/27/2017,1,0,17252,1,20,0.555509746,0.444490269,1,20,746,87,219,20,757
58,3/28/2017,1,0,17253,1,-14,0.668924361,0.331075579,1,-14,732,65,31,-14,743
59,3/29/2017,0,1,17254,0,-82,0.338162675,0.661837339,-1,82,814,128,30,82,825
60,3/30/2017,1,0,17255,1,-137,0.628736764,0.371263266,1,-137,677,178,9,-137,688
61,3/31/2017,0,1,17256,0,-190,0.396434635,0.603565395,-1,190,867,227,19,190,878
62,4/3/2017,1,0,17259,1,39,0.598431677,0.401568323,1,39,906,31,67,39,917
63,4/5/2017,1,0,17261,1,95,0.585985839,0.414014161,1,95,1001,162,114,95,1012
64,4/6/2017,0,1,17262,0,-21,0.473643616,0.526356429,-1,21,1022,125,71,21,1033
65,4/7/2017,0,1,17263,0,-60,0.458873481,0.541126519,-1,60,1082,370,4,60,1093
66,4/10/2017,0,1,17266,0,-80,0.435772642,0.564227343,-1,80,1162,134,14,80,1173
67,4/11/2017,1,0,17267,1,-175,0.510177702,0.489822343,1,-175,987,254,52,-200,973
68,4/12/2017,1,0,17268,1,259,0.519244283,0.480755761,1,259,1246,62,275,259,1232
69,4/13/2017,0,1,17269,0,118,0.477286965,0.522713006,-1,-118,1128,27,255,-200,1032
70,4/18/2017,0,1,17274,0,-471,0.371770337,0.628229678,-1,471,1599,483,0,471,1503
71,4/19/2017,1,0,17275,1,-37,0.654937387,0.345062613,1,-37,1562,158,10,-37,1466
72,4/20/2017,0,1,17276,0,276,0.39030166,0.609698355,-1,-276,1286,31,290,-200,1266
73,4/21/2017,1,0,17277,1,-72,0.539153785,0.460846186,1,-72,1214,123,116,-72,1194
74,4/24/2017,0,1,17280,0,-5,0.405972168,0.594027787,-1,5,1219,262,13,5,1199
75,4/25/2017,1,0,17281,1,251,0.5310314,0.46896863,1,251,1470,27,263,251,1450
76,4/26/2017,1,0,17282,1,45,0.530055016,0.469944984,1,45,1515,13,120,45,1495
77,4/27/2017,1,0,17283,1,5,0.500652939,0.499346986,1,5,1520,127,25,5,1500
78,4/28/2017,0,1,17284,0,-29,0.404009208,0.595990777,-1,29,1549,110,19,29,1529
79,5/2/2017,0,1,17288,0,-22,0.428287685,0.571712285,-1,22,1571,121,113,22,1551
80,5/4/2017,0,1,17290,0,17,0.348375648,0.651624352,-1,-17,1554,115,38,-17,1534
81,5/5/2017,0,1,17291,0,-117,0.333342865,0.66665715,-1,117,1671,252,45,117,1651
82,5/8/2017,1,0,17294,1,-23,0.562465429,0.437534526,1,-23,1648,113,28,-23,1628
83,5/9/2017,0,1,17295,0,281,0.360591635,0.63940835,-1,-281,1367,56,334,-200,1428
84,5/10/2017,0,1,17296,0,118,0.401636228,0.598363787,-1,-118,1249,16,265,-200,1228
85,5/11/2017,1,0,17297,1,48,0.541443169,0.458556801,1,48,1297,95,81,48,1276
86,5/12/2017,0,1,17298,0,55,0.466419175,0.53358084,-1,-55,1242,46,89,-55,1221
87,5/15/2017,1,0,17301,1,59,0.551845491,0.448154509,1,59,1301,65,125,59,1280
88,5/16/2017,0,1,17302,0,-39,0.482165575,0.517834365,-1,39,1340,134,9,39,1319
89,5/17/2017,1,0,17303,1,40,0.503391892,0.496608049,1,40,1380,66,50,40,1359
90,5/18/2017,1,0,17304,1,77,0.539176971,0.460823029,1,77,1457,37,159,77,1436
91,5/19/2017,0,1,17305,0,45,0.375608638,0.624391317,-1,-45,1412,34,102,-45,1391
92,5/22/2017,1,0,17308,1,59,0.612553149,0.387446865,1,59,1471,88,140,59,1450
93,5/23/2017,0,1,17309,0,27,0.449335754,0.550664276,-1,-27,1444,76,70,-27,1423
94,5/24/2017,0,1,17310,0,42,0.376710936,0.623289078,-1,-42,1402,75,44,-42,1381
95,5/25/2017,1,0,17311,1,193,0.544384956,0.455615059,1,193,1595,4,226,193,1574
96,5/26/2017,0,1,17312,0,-44,0.408709064,0.591290951,-1,44,1639,84,54,44,1618
97,5/29/2017,1,0,17315,1,58,0.513380408,0.486619562,1,58,1697,32,73,58,1676
98,5/31/2017,0,1,17317,0,-35,0.448040009,0.551959962,-1,35,1732,56,107,35,1711
99,6/1/2017,0,1,17318,0,121,0.394696504,0.605303437,-1,-121,1611,65,128,-121,1590
100,6/2/2017,0,1,17319,0,9,0.354485467,0.645514548,-1,-9,1602,83,76,-9,1581
101,6/5/2017,1,0,17322,1,-29,0.520265549,0.47973448,1,-29,1573,58,96,-29,1552
102,6/6/2017,0,1,17323,0,199,0.402548894,0.597451061,-1,-199,1374,4,209,-200,1352
103,6/7/2017,1,0,17324,1,-42,0.608332664,0.391667351,1,-42,1332,97,47,-42,1310
104,6/8/2017,0,1,17325,0,145,0.348623961,0.651376039,-1,-145,1187,0,167,-145,1165
105,6/9/2017,1,0,17326,1,-21,0.517975897,0.482024074,1,-21,1166,121,35,-21,1144
106,6/12/2017,0,1,17329,0,-225,0.335927084,0.664072871,-1,225,1391,258,10,225,1369
107,6/13/2017,0,1,17330,0,36,0.382059708,0.617940336,-1,-36,1355,80,78,-36,1333
108,6/14/2017,0,1,17331,0,-21,0.483450428,0.516549587,-1,21,1376,205,21,21,1354
109,6/15/2017,0,1,17332,0,-214,0.372313887,0.627686113,-1,214,1590,246,0,214,1568
110,6/16/2017,0,1,17333,0,-4,0.347768471,0.652231514,-1,4,1594,66,67,4,1572
111,6/19/2017,0,1,17336,0,253,0.464983389,0.535016626,-1,-253,1341,3,270,-200,1372
112,6/20/2017,0,1,17337,0,-109,0.343819201,0.656180859,-1,109,1450,129,55,109,1481
113,6/21/2017,0,1,17338,0,-111,0.395691022,0.604308993,-1,111,1561,199,126,111,1592
114,6/22/2017,0,1,17339,0,133,0.439139545,0.560860455,-1,-133,1428,26,276,-200,1392
115,6/23/2017,1,0,17340,1,-35,0.633486032,0.366513982,1,-35,1393,79,70,-35,1357
116,6/26/2017,1,0,17343,1,144,0.55368486,0.44631514,1,144,1537,5,173,144,1501
117,6/27/2017,1,0,17344,1,-74,0.616352618,0.383647367,1,-74,1463,117,34,-74,1427
118,6/28/2017,0,1,17345,0,-49,0.34705323,0.6529468,-1,49,1512,115,85,49,1476
119,6/29/2017,1,0,17346,1,64,0.600236923,0.399763107,1,64,1576,21,72,64,1540
120,6/30/2017,0,1,17347,0,11,0.418110147,0.581889808,-1,-11,1565,128,101,-11,1529
121,7/3/2017,1,0,17350,1,159,0.508386672,0.491613343,1,159,1724,18,201,159,1688
122,7/4/2017,0,1,17351,0,-370,0.494773284,0.505226672,-1,370,2094,545,66,370,2058
123,7/5/2017,1,0,17352,1,174,0.538766146,0.461233854,1,174,2268,179,196,174,2232
124,7/6/2017,0,1,17353,0,-54,0.481268391,0.518731624,-1,54,2322,149,48,54,2286
125,7/7/2017,0,1,17354,0,17,0.498269752,0.501730278,-1,-17,2305,52,73,-17,2269
126,7/10/2017,0,1,17357,0,137,0.4386127,0.5613873,-1,-137,2168,73,226,-200,2069
127,7/11/2017,1,0,17358,1,415,0.643791854,0.356208131,1,415,2583,11,415,415,2484
128,7/12/2017,1,0,17359,1,173,0.657890648,0.342109352,1,173,2756,0,250,173,2657
129,7/13/2017,1,0,17360,1,48,0.650135189,0.349864826,1,48,2804,56,59,48,2705
130,7/14/2017,1,0,17361,1,-12,0.559579909,0.440420136,1,-12,2792,80,32,-12,2693
131,7/17/2017,1,0,17364,1,-108,0.540630072,0.459369943,1,-108,2684,217,35,-200,2493
132,7/18/2017,1,0,17365,1,76,0.621082783,0.378917247,1,76,2760,72,76,76,2569
133,7/19/2017,1,0,17366,1,124,0.687550336,0.312449619,1,124,2884,28,158,124,2693
134,7/20/2017,1,0,17367,1,5,0.564471453,0.435528502,1,5,2889,84,34,5,2698
135,7/21/2017,0,1,17368,0,15,0.490453303,0.509546697,-1,-15,2874,87,23,-15,2683
136,7/24/2017,1,0,17371,1,157,0.575034976,0.424965039,1,157,3031,23,183,157,2840
137,7/25/2017,1,0,17372,1,49,0.542159677,0.457840338,1,49,3080,21,56,49,2889
138,7/26/2017,1,0,17373,1,5,0.538121462,0.461878493,1,5,3085,111,82,5,2894
139,7/27/2017,1,0,17374,1,165,0.622839034,0.377160937,1,165,3250,19,203,165,3059
140,7/28/2017,0,1,17375,0,-61,0.360088602,0.639911383,-1,61,3311,89,0,61,3120
141,7/31/2017,1,0,17378,1,262,0.66943711,0.330562934,1,262,3573,15,275,262,3382
142,8/1/2017,0,1,17379,0,303,0.485172823,0.514827132,-1,-303,3270,0,313,-200,3182
143,8/2/2017,1,0,17380,1,47,0.541181266,0.458818763,1,47,3317,22,150,47,3229
144,8/3/2017,1,0,17381,1,38,0.641610503,0.358389467,1,38,3355,97,98,38,3267
145,8/4/2017,1,0,17382,1,-15,0.525171667,0.474828318,1,-15,3340,86,26,-15,3252
146,8/7/2017,1,0,17385,1,37,0.526548624,0.473451406,1,37,3377,16,144,37,3289
147,8/8/2017,1,0,17386,1,193,0.577689141,0.422310874,1,193,3570,39,208,193,3482
148,8/9/2017,1,0,17387,1,-55,0.50407815,0.49592188,1,-55,3515,190,45,-55,3427
149,8/10/2017,1,0,17388,1,-360,0.654740036,0.345259979,1,-360,3155,531,21,-200,3227
150,8/11/2017,0,1,17389,0,-143,0.468429402,0.531570584,-1,143,3298,151,189,143,3370
151,8/14/2017,1,0,17392,1,87,0.596290499,0.403709486,1,87,3385,80,148,87,3457
152,8/15/2017,1,0,17393,1,-173,0.502416968,0.497583002,1,-173,3212,203,75,-200,3257
153,8/16/2017,1,0,17394,1,323,0.566698819,0.433301181,1,323,3535,27,334,323,3580
154,8/17/2017,1,0,17395,1,-296,0.650176376,0.349823639,1,-296,3239,333,14,-200,3380
155,8/18/2017,1,0,17396,1,-28,0.519405901,0.480594113,1,-28,3211,136,158,-28,3352
156,8/21/2017,1,0,17399,1,113,0.609569401,0.390430585,1,113,3324,24,154,113,3465
157,8/22/2017,1,0,17400,1,135,0.536462396,0.463537619,1,135,3459,14,201,135,3600
158,8/24/2017,1,0,17402,1,8,0.64714855,0.35285148,1,8,3467,52,83,8,3608
159,8/25/2017,1,0,17403,1,346,0.638082504,0.361917466,1,346,3813,147,346,346,3954
160,8/28/2017,0,1,17406,0,41,0.489298224,0.510701805,-1,-41,3772,28,220,-200,3754
161,8/29/2017,1,0,17407,1,-84,0.604731768,0.395268247,1,-84,3688,148,32,-84,3670
162,8/30/2017,1,0,17408,1,154,0.667351484,0.332648531,1,154,3842,0,165,154,3824
163,8/31/2017,0,1,17409,0,7,0.465162307,0.534837723,-1,-7,3835,110,36,-7,3817
164,9/1/2017,1,0,17410,1,-111,0.580089688,0.419910297,1,-111,3724,129,70,-111,3706
165,9/4/2017,1,0,17413,1,-54,0.596443385,0.403556615,1,-54,3670,199,60,-54,3652
166,9/5/2017,0,1,17414,0,-65,0.495648995,0.50435096,-1,65,3735,148,48,65,3717
167,9/6/2017,1,0,17415,1,-26,0.60597533,0.39402464,1,-26,3709,261,39,-200,3517
168,9/7/2017,1,0,17416,1,-262,0.614291251,0.385708764,1,-262,3447,310,48,-200,3317
169,9/8/2017,1,0,17417,1,140,0.666275471,0.333724543,1,140,3587,18,149,140,3457
170,9/11/2017,0,1,17420,0,161,0.402745292,0.597254694,-1,-161,3426,5,217,-200,3257
171,9/12/2017,0,1,17421,0,-73,0.400000915,0.59999913,-1,73,3499,143,34,73,3330
172,9/13/2017,0,1,17422,0,-92,0.465249047,0.534750938,-1,92,3591,244,28,92,3422
173,9/14/2017,0,1,17423,0,-34,0.415145516,0.584854513,-1,34,3625,146,58,34,3456
174,9/15/2017,1,0,17424,1,53,0.583175749,0.416824192,1,53,3678,266,190,-200,3256
175,9/18/2017,1,0,17427,1,228,0.573913306,0.426086679,1,228,3906,29,235,228,3484
176,9/19/2017,1,0,17428,1,-100,0.54892087,0.45107913,1,-100,3806,121,90,-100,3384
177,9/20/2017,0,1,17429,0,74,0.435365632,0.564634353,-1,-74,3732,56,79,-74,3310
178,9/21/2017,0,1,17430,0,38,0.406226501,0.593773544,-1,-38,3694,56,84,-38,3272
179,9/22/2017,0,1,17431,0,-223,0.4630633,0.536936641,-1,223,3917,236,3,223,3495
180,9/25/2017,1,0,17434,1,-419,0.590876669,0.409123302,1,-419,3498,431,1,-200,3295
181,9/26/2017,0,1,17435,0,207,0.431336746,0.568663239,-1,-207,3291,71,224,-200,3095
182,9/27/2017,0,1,17436,0,177,0.409809977,0.590190023,-1,-177,3114,27,212,-200,2895
183,9/28/2017,0,1,17437,0,-26,0.342994362,0.657005578,-1,26,3140,99,76,26,2921
184,9/29/2017,1,0,17438,1,51,0.609281957,0.390718028,1,51,3191,128,78,51,2972
185,10/3/2017,1,0,17442,1,399,0.501126423,0.498873591,1,399,3590,61,399,399,3371
186,10/4/2017,1,0,17443,1,150,0.548690587,0.451309443,1,150,3740,1,330,150,3521
187,10/6/2017,0,1,17445,0,-165,0.483829439,0.516170561,-1,165,3905,214,23,165,3686
188,10/9/2017,1,0,17448,1,-75,0.571569353,0.428430617,1,-75,3830,167,50,-75,3611
189,10/10/2017,1,0,17449,1,88,0.506908149,0.493091866,1,88,3918,103,125,88,3699
190,10/11/2017,0,1,17450,0,-270,0.482760623,0.517239362,-1,270,4188,310,24,270,3969
191,10/12/2017,1,0,17451,1,-7,0.51233682,0.48766318,1,-7,4181,84,96,-7,3962
192,10/13/2017,1,0,17452,1,55,0.667530119,0.332469866,1,55,4236,47,109,55,4017
193,10/16/2017,1,0,17455,1,61,0.574546993,0.425453037,1,61,4297,53,154,61,4078
194,10/17/2017,0,1,17456,0,-33,0.330603287,0.669396728,-1,33,4330,99,27,33,4111
195,10/18/2017,0,1,17457,0,34,0.451858208,0.548141778,-1,-34,4296,22,81,-34,4077
196,10/19/2017,0,1,17458,0,-524,0.368473724,0.631526291,-1,524,4820,694,24,524,4601
197,10/20/2017,1,0,17459,1,59,0.581074417,0.418925583,1,59,4879,41,171,59,4660
198,10/23/2017,0,1,17462,0,-219,0.421688288,0.578311652,-1,219,5098,328,9,219,4879
199,10/24/2017,0,1,17463,0,-68,0.358452439,0.641547531,-1,68,5166,158,110,68,4947
200,10/25/2017,0,1,17464,0,29,0.476195157,0.523804814,-1,-29,5137,89,107,-29,4918
201,10/26/2017,0,1,17465,0,150,0.402115628,0.597884387,-1,-150,4987,43,178,-150,4768
202,10/27/2017,0,1,17466,0,112,0.467720047,0.532279998,-1,-112,4875,34,168,-112,4656
203,10/30/2017,1,0,17469,1,-104,0.643436611,0.356563419,1,-104,4771,195,82,-104,4552
204,10/31/2017,1,0,17470,1,-17,0.563234091,0.436765924,1,-17,4754,57,127,-17,4535
205,11/1/2017,1,0,17471,1,228,0.505637586,0.494362399,1,228,4982,69,267,228,4763
206,11/2/2017,0,1,17472,0,16,0.344435543,0.655564487,-1,-16,4966,87,82,-16,4747
207,11/3/2017,1,0,17473,1,-12,0.669729888,0.330270082,1,-12,4954,91,32,-12,4735
208,11/6/2017,0,1,17476,0,47,0.377470911,0.622529089,-1,-47,4907,478,69,-47,4688
209,11/7/2017,1,0,17477,1,294,0.651444316,0.348555684,1,294,5201,19,345,294,4982
210,11/8/2017,0,1,17478,0,90,0.354099467,0.645900518,-1,-90,5111,0,270,-200,4782
211,11/9/2017,0,1,17479,0,172,0.349784836,0.650215149,-1,-172,4939,4,216,-200,4582
212,11/10/2017,1,0,17480,1,33,0.511140496,0.488859564,1,33,4972,48,143,33,4615
213,11/13/2017,0,1,17483,0,166,0.341312334,0.658687711,-1,-166,4806,37,206,-200,4415
214,11/14/2017,1,0,17484,1,-47,0.51143688,0.488563061,1,-47,4759,89,51,-47,4368
215,11/15/2017,0,1,17485,0,-187,0.388451889,0.611548156,-1,187,4946,207,3,187,4555
216,11/16/2017,1,0,17486,1,133,0.650039226,0.349960774,1,133,5079,36,170,133,4688
217,11/17/2017,0,1,17487,0,-41,0.315905884,0.684094101,-1,41,5120,93,76,41,4729
218,11/20/2017,1,0,17490,1,48,0.566905111,0.433094859,1,48,5168,89,88,48,4777
219,11/21/2017,0,1,17491,0,500,0.474387556,0.525612444,-1,-500,4668,66,501,-200,4577
220,11/22/2017,0,1,17492,0,24,0.381316841,0.618683159,-1,-24,4644,90,186,-24,4553
221,11/23/2017,1,0,17493,1,-230,0.618801832,0.381198213,1,-230,4414,443,118,-200,4353
222,11/24/2017,0,1,17494,0,21,0.478096291,0.521903664,-1,-21,4393,152,70,-21,4332
223,11/27/2017,0,1,17497,0,-143,0.370472044,0.629527956,-1,143,4536,272,42,143,4475
224,11/28/2017,0,1,17498,0,-27,0.420964256,0.579035729,-1,27,4563,313,17,27,4502
225,11/29/2017,0,1,17499,0,-213,0.331887364,0.668112665,-1,213,4776,278,0,213,4715
226,11/30/2017,0,1,17500,0,-154,0.333988205,0.666011781,-1,154,4930,334,5,154,4869
227,12/1/2017,0,1,17501,0,-214,0.349089697,0.650910258,-1,214,5144,282,54,214,5083
228,12/4/2017,1,0,17504,1,43,0.602861732,0.397138268,1,43,5187,322,204,-200,4883
229,12/5/2017,0,1,17505,0,-4,0.363883406,0.636116564,-1,4,5191,40,269,-200,4683
230,12/6/2017,0,1,17506,0,-690,0.499539718,0.500460267,-1,690,5881,729,79,690,5373
231,12/7/2017,1,0,17507,1,-88,0.629851699,0.370148316,1,-88,5793,251,79,-200,5173
232,12/8/2017,0,1,17508,0,192,0.416049823,0.583950162,-1,-192,5601,98,287,-200,4973
233,12/11/2017,0,1,17511,0,304,0.426192418,0.573807597,-1,-304,5297,15,379,-200,4773
234,12/12/2017,0,1,17512,0,-154,0.470976427,0.529023588,-1,154,5451,214,95,154,4927
235,12/13/2017,0,1,17513,0,408,0.487430587,0.512569368,-1,-408,5043,81,502,-200,4727
236,12/14/2017,1,0,17514,1,-122,0.546640128,0.453359902,1,-122,4921,276,118,-200,4527
237,12/15/2017,1,0,17515,1,-240,0.564712495,0.435287461,1,-240,4681,294,20,-200,4327
238,12/18/2017,0,1,17518,0,135,0.466030508,0.533969492,-1,-135,4546,161,165,-135,4192
239,12/19/2017,0,1,17519,0,71,0.41795148,0.582048535,-1,-71,4475,20,205,-200,3992
240,12/20/2017,0,1,17520,0,161,0.462439701,0.537560284,-1,-161,4314,11,199,-161,3831
241,12/21/2017,0,1,17521,0,120,0.466693833,0.533306152,-1,-120,4194,105,210,-200,3631
242,12/22/2017,1,0,17522,1,85,0.575424016,0.424575999,1,85,4279,102,95,85,3716
243,12/27/2017,1,0,17527,1,2,0.571113199,0.428886786,1,2,4281,128,59,2,3718
244,12/28/2017,1,0,17528,1,79,0.631894857,0.368105143,1,79,4360,26,93,79,3797
245,12/29/2017,0,1,17529,0,33,0.446174011,0.553825974,-1,-33,4327,44,112,-33,3764
0,1/2/2018,1,0,17533,1,513,0.604270637,0.395729363,1,513,513,17,546,513,513
1,1/3/2018,1,0,17534,1,25,0.644524097,0.355475888,1,25,538,78,160,25,538
2,1/4/2018,1,0,17535,1,8,0.507755965,0.49224402,1,8,546,149,55,8,546
3,1/5/2018,0,1,17536,0,-126,0.336332172,0.663667828,-1,126,672,197,22,126,672
4,1/8/2018,0,1,17539,0,-104,0.425917298,0.574082732,-1,104,776,208,10,104,776
5,1/9/2018,0,1,17540,0,35,0.416785344,0.58321467,-1,-35,741,114,108,-35,741
6,1/10/2018,0,1,17541,0,65,0.334492698,0.665507287,-1,-65,676,53,295,-200,541
7,1/11/2018,0,1,17542,0,43,0.435304895,0.56469509,-1,-43,633,71,91,-43,498
8,1/12/2018,0,1,17543,0,173,0.483293235,0.516706765,-1,-173,460,39,175,-173,325
9,1/15/2018,1,0,17546,1,-327,0.537965864,0.462034136,1,-327,133,369,74,-200,125
10,1/16/2018,1,0,17547,1,502,0.568933308,0.431066707,1,502,635,30,552,502,627
11,1/17/2018,0,1,17548,0,249,0.394212395,0.605787575,-1,-249,386,33,286,-200,427
12,1/18/2018,0,1,17549,0,-132,0.428158969,0.571841061,-1,132,518,356,9,132,559
13,1/19/2018,1,0,17550,1,150,0.51988399,0.480116025,1,150,668,96,163,150,709
14,1/22/2018,1,0,17553,1,11,0.50340271,0.496597305,1,11,679,327,43,-200,509
15,1/23/2018,0,1,17554,0,358,0.435494587,0.564505428,-1,-358,321,35,377,-200,309
16,1/24/2018,1,0,17555,1,60,0.598955572,0.401044369,1,60,381,104,161,60,369
17,1/25/2018,1,0,17556,1,-224,0.643767923,0.356232062,1,-224,157,284,112,-200,169
18,1/26/2018,0,1,17557,0,297,0.457483187,0.542516828,-1,-297,-140,57,346,-200,-31
19,1/29/2018,1,0,17560,1,-434,0.551252842,0.448747098,1,-434,-574,480,182,-200,-231
20,1/30/2018,0,1,17561,0,-117,0.365959555,0.634040445,-1,117,-457,191,138,117,-114
21,1/31/2018,1,0,17562,1,423,0.548698753,0.451301232,1,423,-34,128,508,423,309
22,2/1/2018,1,0,17563,1,-176,0.65614745,0.343852535,1,-176,-210,259,152,-200,109
23,2/2/2018,0,1,17564,0,-63,0.43054229,0.56945774,-1,63,-147,303,172,63,172
24,2/5/2018,0,1,17567,0,355,0.489993349,0.510006636,-1,-355,-502,51,641,-200,-28
25,2/6/2018,1,0,17568,1,-165,0.606844395,0.393155605,1,-165,-667,393,332,-200,-228
26,2/7/2018,1,0,17569,1,-1016,0.638341486,0.361658543,1,-1016,-1683,1143,167,-200,-428
27,2/8/2018,0,1,17570,0,-86,0.382603779,0.617396265,-1,86,-1597,287,211,-200,-628
28,2/9/2018,0,1,17571,0,-203,0.462479487,0.537520528,-1,203,-1394,462,106,203,-425
29,2/12/2018,1,0,17574,1,-181,0.575472027,0.424527988,1,-181,-1575,262,106,-200,-625
30,2/13/2018,1,0,17575,1,12,0.600708455,0.39929156,1,12,-1563,56,411,12,-613
31,2/14/2018,1,0,17576,1,411,0.704918116,0.295081869,1,411,-1152,39,695,411,-202
32,2/15/2018,1,0,17577,1,315,0.66895771,0.331042275,1,315,-837,2,386,315,113
33,2/20/2018,1,0,17582,1,-436,0.520620197,0.479379773,1,-436,-1273,579,92,-200,-87
34,2/21/2018,1,0,17583,1,473,0.629268199,0.370731771,1,473,-800,81,498,473,386
35,2/22/2018,0,1,17584,0,-300,0.458187237,0.541812718,-1,300,-500,363,0,300,686
36,2/23/2018,1,0,17585,1,-39,0.659798533,0.340201452,1,-39,-539,103,155,-39,647
37,2/26/2018,1,0,17588,1,104,0.617976815,0.382023185,1,104,-435,135,142,104,751
38,2/27/2018,1,0,17589,1,-293,0.542750686,0.457249299,1,-293,-728,303,25,-200,551
39,2/28/2018,0,1,17590,0,-376,0.428945333,0.571054667,-1,376,-352,446,18,376,927
40,3/1/2018,1,0,17591,1,518,0.535542697,0.464457288,1,518,166,153,573,518,1445
41,3/2/2018,1,0,17592,1,-20,0.700205415,0.299794555,1,-20,146,126,87,-20,1425
42,3/5/2018,1,0,17595,1,-464,0.633269757,0.366730243,1,-464,-318,600,285,-200,1225
43,3/6/2018,1,0,17596,1,94,0.571256042,0.428743958,1,94,-224,275,204,-200,1025
44,3/7/2018,1,0,17597,1,52,0.623720556,0.376279458,1,52,-172,90,483,52,1077
45,3/8/2018,1,0,17598,1,191,0.504304916,0.49569504,1,191,19,66,271,191,1268
46,3/9/2018,1,0,17599,1,156,0.524867833,0.475132108,1,156,175,23,204,156,1424
47,3/12/2018,0,1,17602,0,142,0.381430298,0.618569672,-1,-142,33,104,188,-142,1282
48,3/13/2018,1,0,17603,1,36,0.631774247,0.368225709,1,36,69,65,164,36,1318
49,3/14/2018,1,0,17604,1,173,0.652858108,0.347141936,1,173,242,168,216,173,1491
50,3/15/2018,1,0,17605,1,400,0.592738062,0.407261893,1,400,642,89,480,400,1891
51,3/16/2018,0,1,17606,0,45,0.439079866,0.560920089,-1,-45,597,137,172,-45,1846
52,3/19/2018,0,1,17609,0,-7,0.371202499,0.628797501,-1,7,604,191,277,-200,1646
53,3/20/2018,1,0,17610,1,248,0.646745831,0.353254169,1,248,852,152,287,248,1894
54,3/21/2018,1,0,17611,1,-346,0.518270671,0.481729284,1,-346,506,364,305,-200,1694
55,3/22/2018,1,0,17612,1,-529,0.677236944,0.322763056,1,-529,-23,591,124,-200,1494
56,3/23/2018,1,0,17613,1,104,0.688997895,0.31100212,1,104,81,187,288,104,1598
57,3/26/2018,1,0,17616,1,577,0.640418261,0.359581694,1,577,658,17,622,577,2175
58,3/27/2018,0,1,17617,0,-126,0.434113055,0.565886885,-1,126,784,186,44,126,2301
59,3/28/2018,0,1,17618,0,-78,0.438675836,0.561324179,-1,78,862,108,224,-200,2101
60,3/29/2018,0,1,17619,0,-145,0.36517857,0.634821445,-1,145,1007,443,11,145,2246
61,4/3/2018,1,0,17624,1,287,0.517892927,0.482107073,1,287,1294,115,430,287,2533
62,4/4/2018,0,1,17625,0,-725,0.32552205,0.674477965,-1,725,2019,787,185,725,3258
63,4/6/2018,0,1,17627,0,37,0.310067967,0.689932019,-1,-37,1982,238,177,-37,3221
64,4/9/2018,1,0,17630,1,283,0.680660039,0.319339961,1,283,2265,88,580,283,3504
65,4/10/2018,0,1,17631,0,597,0.348370254,0.651629746,-1,-597,1668,28,652,-200,3304
66,4/11/2018,0,1,17632,0,130,0.420647368,0.579352617,-1,-130,1538,75,239,-200,3104
67,4/12/2018,1,0,17633,1,-320,0.688033938,0.311966047,1,-320,1218,482,64,-200,2904
68,4/13/2018,0,1,17634,0,-161,0.348797366,0.651202619,-1,161,1379,322,27,161,3065
69,4/16/2018,0,1,17637,0,-817,0.485273272,0.514726698,-1,817,2196,839,3,817,3882
70,4/17/2018,0,1,17638,0,-294,0.32283698,0.677163035,-1,294,2490,357,178,294,4176
71,4/18/2018,1,0,17639,1,-186,0.593517363,0.406482622,1,-186,2304,544,10,-200,3976
72,4/19/2018,0,1,17640,0,263,0.445072815,0.5549272,-1,-263,2041,48,296,-200,3776
73,4/20/2018,0,1,17641,0,-232,0.408391789,0.591608256,-1,232,2273,273,289,-200,3576
74,4/23/2018,0,1,17644,0,-117,0.370894954,0.629105091,-1,117,2390,215,142,117,3693
75,4/24/2018,0,1,17645,0,285,0.405864313,0.594135702,-1,-285,2105,87,348,-200,3493
76,4/25/2018,0,1,17646,0,-299,0.363064378,0.636935622,-1,299,2404,299,39,299,3792
77,4/26/2018,0,1,17647,0,-295,0.325080499,0.674919486,-1,295,2699,495,123,295,4087
78,4/27/2018,1,0,17648,1,-124,0.530151397,0.469848588,1,-124,2575,206,36,-200,3887
79,4/30/2018,0,1,17651,0,420,0.457664773,0.542335212,-1,-420,2155,15,479,-200,3687
80,5/2/2018,0,1,17653,0,55,0.412218377,0.587781638,-1,-55,2100,108,159,-55,3632
81,5/3/2018,0,1,17654,0,-249,0.408748448,0.591251582,-1,249,2349,404,22,249,3881
82,5/4/2018,1,0,17655,1,-252,0.533938676,0.466061294,1,-252,2097,388,137,-200,3681
83,5/7/2018,0,1,17658,0,-242,0.370322526,0.629677474,-1,242,2339,419,47,242,3923
84,5/8/2018,0,1,17659,0,392,0.415400356,0.584599674,-1,-392,1947,9,455,-200,3723
85,5/9/2018,0,1,17660,0,200,0.376014799,0.623985201,-1,-200,1747,73,202,-200,3523
86,5/10/2018,1,0,17661,1,194,0.56651625,0.433483735,1,194,1941,17,215,194,3717
87,5/11/2018,1,0,17662,1,124,0.510887414,0.489112601,1,124,2065,101,173,124,3841
88,5/14/2018,0,1,17665,0,158,0.346836299,0.653163701,-1,-158,1907,40,175,-158,3683
89,5/15/2018,0,1,17666,0,-440,0.347075656,0.652924329,-1,440,2347,472,10,440,4123
90,5/16/2018,0,1,17667,0,46,0.397134468,0.602865517,-1,-46,2301,247,197,-46,4077
91,5/17/2018,0,1,17668,0,-344,0.390832633,0.609167397,-1,344,2645,404,96,344,4421
92,5/18/2018,0,1,17669,0,6,0.329848871,0.670151174,-1,-6,2639,108,187,-6,4415
93,5/21/2018,1,0,17672,1,96,0.5616045,0.43839553,1,96,2735,41,277,96,4511
94,5/23/2018,0,1,17674,0,-585,0.44791013,0.55208984,-1,585,3320,608,10,585,5096
95,5/24/2018,1,0,17675,1,58,0.608525157,0.391474843,1,58,3378,127,127,58,5154
96,5/25/2018,1,0,17676,1,-6,0.526551425,0.473448604,1,-6,3372,156,112,-6,5148
97,5/28/2018,0,1,17679,0,30,0.364496499,0.635503531,-1,-30,3342,212,128,-30,5118
98,5/29/2018,0,1,17680,0,-219,0.497568905,0.502431095,-1,219,3561,226,67,219,5337
99,5/30/2018,1,0,17681,1,-112,0.717956722,0.282043248,1,-112,3449,183,65,-112,5225
100,5/31/2018,0,1,17682,0,402,0.464044571,0.535955459,-1,-402,3047,118,418,-200,5025
101,6/1/2018,1,0,17683,1,5,0.644131869,0.355868146,1,5,3052,132,80,5,5030
102,6/4/2018,0,1,17686,0,299,0.287875041,0.712124944,-1,-299,2753,4,350,-200,4830
103,6/5/2018,0,1,17687,0,150,0.444180682,0.555819333,-1,-150,2603,101,250,-200,4630
104,6/6/2018,0,1,17688,0,165,0.403757185,0.596242756,-1,-165,2438,6,241,-200,4430
105,6/7/2018,0,1,17689,0,125,0.368728667,0.631271333,-1,-125,2313,93,134,-125,4305
106,6/8/2018,0,1,17690,0,-548,0.400389388,0.599610656,-1,548,2861,590,17,548,4853
107,6/11/2018,0,1,17693,0,28,0.369305283,0.630694747,-1,-28,2833,181,105,-28,4825
108,6/12/2018,0,1,17694,0,63,0.41078493,0.5892151,-1,-63,2770,106,258,-200,4625
109,6/13/2018,0,1,17695,0,-237,0.489571288,0.510428697,-1,237,3007,343,23,237,4862
110,6/14/2018,0,1,17696,0,-190,0.368601874,0.631398112,-1,190,3197,334,136,190,5052
111,6/15/2018,1,0,17697,1,-162,0.552398384,0.447601587,1,-162,3035,200,66,-200,4852
112,6/19/2018,1,0,17701,1,-511,0.672383964,0.327616006,1,-511,2524,615,45,-200,4652
113,6/20/2018,1,0,17702,1,187,0.699947655,0.300052345,1,187,2711,135,491,187,4839
114,6/21/2018,0,1,17703,0,-424,0.436345533,0.563654482,-1,424,3135,486,140,424,5263
115,6/22/2018,1,0,17704,1,292,0.517475873,0.482524112,1,292,3427,0,384,292,5555
116,6/25/2018,0,1,17707,0,-464,0.461983562,0.538016468,-1,464,3891,553,36,464,6019
117,6/26/2018,1,0,17708,1,46,0.682390809,0.317609176,1,46,3937,423,134,-200,5819
118,6/27/2018,1,0,17709,1,-627,0.61846447,0.3815355,1,-627,3310,724,48,-200,5619
119,6/28/2018,1,0,17710,1,30,0.558985502,0.441014469,1,30,3340,68,156,30,5649
120,6/29/2018,1,0,17711,1,463,0.522491872,0.477508202,1,463,3803,14,502,463,6112
121,7/3/2018,1,0,17715,1,-71,0.567927152,0.432072848,1,-71,3732,613,37,-200,5912
122,7/4/2018,1,0,17716,1,-174,0.559648216,0.440351814,1,-174,3558,292,226,-200,5712
123,7/5/2018,1,0,17717,1,156,0.506284282,0.493715703,1,156,3714,321,219,-200,5512
124,7/6/2018,1,0,17718,1,20,0.577670336,0.422329664,1,20,3734,380,293,-200,5312
125,7/9/2018,1,0,17721,1,61,0.621481478,0.378518462,1,61,3795,132,184,61,5373
126,7/10/2018,0,1,17722,0,-300,0.462813213,0.537186742,-1,300,4095,390,63,300,5673
127,7/11/2018,0,1,17723,0,208,0.405994967,0.594005048,-1,-208,3887,188,285,-200,5473
128,7/12/2018,1,0,17724,1,179,0.603368014,0.396631971,1,179,4066,146,324,179,5652
129,7/13/2018,0,1,17725,0,-184,0.382960841,0.617039144,-1,184,4250,265,27,184,5836
130,7/16/2018,0,1,17728,0,-113,0.448186547,0.551813394,-1,113,4363,323,79,113,5949
131,7/17/2018,0,1,17729,0,-193,0.398004398,0.601995587,-1,193,4556,266,87,193,6142
132,7/18/2018,0,1,17730,0,-330,0.495435968,0.504564032,-1,330,4886,398,0,330,6472
133,7/19/2018,0,1,17731,0,-201,0.39046064,0.60953933,-1,201,5087,286,75,201,6673
134,7/20/2018,1,0,17732,1,184,0.574265748,0.425734207,1,184,5271,308,259,-200,6473
135,7/23/2018,0,1,17735,0,23,0.489463165,0.510536849,-1,-23,5248,125,196,-23,6450
136,7/24/2018,0,1,17736,0,345,0.321035072,0.678964943,-1,-345,4903,85,415,-200,6250
137,7/25/2018,0,1,17737,0,91,0.398759559,0.601240456,-1,-91,4812,73,153,-91,6159
138,7/26/2018,1,0,17738,1,-297,0.592859983,0.407139972,1,-297,4515,424,73,-200,5959
139,7/27/2018,0,1,17739,0,-21,0.373987168,0.626012832,-1,21,4536,163,86,21,5980
140,7/30/2018,0,1,17742,0,43,0.479004264,0.520995766,-1,-43,4493,19,236,-200,5780
141,7/31/2018,0,1,17743,0,-209,0.387825847,0.612174153,-1,209,4702,216,28,209,5989
142,8/1/2018,1,0,17744,1,-371,0.604768962,0.395231053,1,-371,4331,503,54,-200,5789
143,8/2/2018,0,1,17745,0,-595,0.382924259,0.617075741,-1,595,4926,700,0,595,6384
144,8/3/2018,1,0,17746,1,-130,0.634630889,0.365369052,1,-130,4796,217,0,-200,6184
145,8/6/2018,1,0,17749,1,-102,0.591881871,0.408118129,1,-102,4694,199,186,-102,6082
146,8/7/2018,0,1,17750,0,397,0.465308979,0.534691036,-1,-397,4297,36,427,-200,5882
147,8/8/2018,0,1,17751,0,-56,0.337684557,0.662315428,-1,56,4353,148,84,56,5938
148,8/9/2018,0,1,17752,0,384,0.400379896,0.599620134,-1,-384,3969,65,512,-200,5738
149,8/10/2018,0,1,17753,0,-276,0.439990059,0.560009986,-1,276,4245,316,91,276,6014
150,8/13/2018,1,0,17756,1,44,0.595807284,0.404192775,1,44,4289,119,183,44,6058
151,8/14/2018,1,0,17757,1,-271,0.545828164,0.454171836,1,-271,4018,464,0,-200,5858
152,8/15/2018,0,1,17758,0,-432,0.412989914,0.587010115,-1,432,4450,512,16,432,6290
153,8/16/2018,0,1,17759,0,244,0.449441224,0.550558746,-1,-244,4206,10,566,-200,6090
154,8/17/2018,0,1,17760,0,-74,0.348967358,0.651032627,-1,74,4280,205,122,74,6164
155,8/20/2018,1,0,17763,1,315,0.518066943,0.481933087,1,315,4595,65,351,315,6479
156,8/21/2018,1,0,17764,1,187,0.538349926,0.461650044,1,187,4782,0,260,187,6666
157,8/22/2018,0,1,17765,0,142,0.459495112,0.540504903,-1,-142,4640,212,197,-142,6524
158,8/23/2018,1,0,17766,1,-229,0.677054286,0.322945684,1,-229,4411,336,66,-200,6324
159,8/24/2018,0,1,17767,0,49,0.384380788,0.615619212,-1,-49,4362,99,236,-200,6124
160,8/27/2018,0,1,17770,0,321,0.464621454,0.535378575,-1,-321,4041,32,342,-200,5924
161,8/28/2018,0,1,17771,0,-168,0.454505041,0.545494914,-1,168,4209,259,89,168,6092
162,8/29/2018,0,1,17772,0,10,0.350389868,0.649610162,-1,-10,4199,84,139,-10,6082
163,8/30/2018,1,0,17773,1,-334,0.647312075,0.35268797,1,-334,3865,347,0,-200,5882
164,8/31/2018,0,1,17774,0,-13,0.40740259,0.592597395,-1,13,3878,144,104,13,5895
165,9/3/2018,1,0,17777,1,-5,0.521598339,0.478401646,1,-5,3873,134,137,-5,5890
166,9/4/2018,0,1,17778,0,337,0.477002755,0.5229972,-1,-337,3536,93,405,-200,5690
167,9/5/2018,0,1,17779,0,-555,0.459568411,0.540431529,-1,555,4091,560,159,555,6245
168,9/6/2018,1,0,17780,1,20,0.520424008,0.479576021,1,20,4111,194,262,20,6265
169,9/7/2018,1,0,17781,1,35,0.500218749,0.499781266,1,35,4146,216,365,-200,6065
170,9/10/2018,0,1,17784,0,-94,0.446468681,0.553531349,-1,94,4240,369,115,94,6159
171,9/11/2018,0,1,17785,0,-295,0.420635968,0.579364032,-1,295,4535,310,61,295,6454
172,9/12/2018,0,1,17786,0,-8,0.461384997,0.538614988,-1,8,4543,179,87,8,6462
173,9/13/2018,1,0,17787,1,267,0.561088324,0.438911706,1,267,4810,113,320,267,6729
174,9/14/2018,0,1,17788,0,25,0.327526212,0.672473758,-1,-25,4785,227,115,-25,6704
175,9/17/2018,0,1,17791,0,-4,0.368193746,0.631806254,-1,4,4789,184,137,4,6708
176,9/18/2018,0,1,17792,0,331,0.455075189,0.544924855,-1,-331,4458,105,459,-200,6508
177,9/19/2018,0,1,17793,0,192,0.327540249,0.672459722,-1,-192,4266,159,275,-200,6308
178,9/20/2018,0,1,17794,0,-104,0.346073046,0.653926939,-1,104,4370,269,62,104,6412
179,9/21/2018,0,1,17795,0,290,0.386954769,0.613045216,-1,-290,4080,138,332,-200,6212
180,9/24/2018,0,1,17798,0,-332,0.454108462,0.545891523,-1,332,4412,409,1,332,6544
181,9/26/2018,0,1,17800,0,281,0.496398181,0.503601819,-1,-281,4131,0,500,-200,6344
182,9/27/2018,0,1,17801,0,-102,0.499028668,0.500971287,-1,102,4233,135,84,102,6446
183,9/28/2018,1,0,17802,1,55,0.600368768,0.399631217,1,55,4288,173,113,55,6501
184,10/2/2018,0,1,17806,0,-766,0.373440802,0.626559198,-1,766,5054,769,0,766,7267
185,10/3/2018,0,1,17807,0,56,0.498768091,0.501231879,-1,-56,4998,130,251,-200,7067
186,10/4/2018,0,1,17808,0,-270,0.307237223,0.692762822,-1,270,5268,343,69,270,7337
187,10/5/2018,0,1,17809,0,64,0.373502612,0.626497358,-1,-64,5204,72,224,-200,7137
188,10/8/2018,0,1,17812,0,-327,0.367744207,0.632255793,-1,327,5531,348,295,-200,6937
189,10/9/2018,1,0,17813,1,-40,0.554712921,0.445287079,1,-40,5491,78,242,-40,6897
190,10/10/2018,1,0,17814,1,-9,0.674743503,0.325256482,1,-9,5482,61,296,-9,6888
191,10/11/2018,1,0,17815,1,-180,0.546232611,0.453767389,1,-180,5302,245,93,-200,6688
192,10/12/2018,1,0,17816,1,245,0.69721359,0.302786365,1,245,5547,182,343,245,6933
193,10/15/2018,0,1,17819,0,-194,0.458445787,0.541554213,-1,194,5741,210,109,194,7127
194,10/16/2018,1,0,17820,1,-96,0.616739243,0.383260787,1,-96,5645,275,197,-200,6927
195,10/18/2018,0,1,17822,0,-270,0.375607863,0.624392122,-1,270,5915,466,13,270,7197
196,10/19/2018,0,1,17823,0,344,0.479849428,0.520150542,-1,-344,5571,55,609,-200,6997
197,10/22/2018,0,1,17826,0,642,0.362188891,0.637811124,-1,-642,4929,3,732,-200,6797
198,10/23/2018,1,0,17827,1,-565,0.59469381,0.405306175,1,-565,4364,635,73,-200,6597
199,10/24/2018,1,0,17828,1,-183,0.680657804,0.319342256,1,-183,4181,218,259,-200,6397
200,10/25/2018,1,0,17829,1,122,0.534788966,0.465211019,1,122,4303,173,219,122,6519
201,10/26/2018,0,1,17830,0,-303,0.391434759,0.608565241,-1,303,4606,434,58,303,6822
202,10/29/2018,1,0,17833,1,-93,0.724135429,0.275864556,1,-93,4513,276,139,-200,6622
203,10/30/2018,0,1,17834,0,11,0.305102125,0.69489789,-1,-11,4502,140,143,-11,6611
204,10/31/2018,0,1,17835,0,164,0.394796699,0.605203301,-1,-164,4338,64,214,-200,6411
205,11/1/2018,0,1,17836,0,262,0.326489434,0.673510522,-1,-262,4076,44,436,-200,6211
206,11/2/2018,1,0,17837,1,679,0.60916996,0.3908301,1,679,4755,46,688,679,6890
207,11/5/2018,0,1,17840,0,-117,0.418888107,0.581111878,-1,117,4872,294,125,117,7007
208,11/6/2018,1,0,17841,1,6,0.524958819,0.475041151,1,6,4878,231,136,-200,6807
209,11/7/2018,0,1,17842,0,73,0.344466478,0.655533493,-1,-73,4805,227,436,-200,6607
210,11/8/2018,0,1,17843,0,-390,0.355281428,0.644718587,-1,390,5195,510,0,390,6997
211,11/9/2018,0,1,17844,0,-425,0.310359061,0.689640969,-1,425,5620,483,50,425,7422
212,11/12/2018,1,0,17847,1,101,0.539261341,0.460738674,1,101,5721,0,303,101,7523
213,11/13/2018,0,1,17848,0,779,0.423452616,0.576547384,-1,-779,4942,52,801,-200,7323
214,11/14/2018,0,1,17849,0,-234,0.406181559,0.593818456,-1,234,5176,358,101,234,7557
215,11/15/2018,1,0,17850,1,197,0.577419281,0.422580764,1,197,5373,295,286,-200,7357
216,11/16/2018,1,0,17851,1,-9,0.558430463,0.441569522,1,-9,5364,334,69,-200,7157
217,11/19/2018,1,0,17854,1,208,0.695494056,0.304505914,1,208,5572,16,296,208,7365
218,11/20/2018,0,1,17855,0,-165,0.499593124,0.500406876,-1,165,5737,259,158,165,7530
219,11/21/2018,0,1,17856,0,439,0.432088748,0.567911237,-1,-439,5298,50,512,-200,7330
220,11/22/2018,0,1,17857,0,-119,0.360605121,0.639394909,-1,119,5417,240,42,119,7449
221,11/23/2018,0,1,17858,0,-80,0.418375313,0.581624717,-1,80,5497,220,61,80,7529
222,11/26/2018,0,1,17861,0,412,0.404387876,0.595612109,-1,-412,5085,11,437,-200,7329
223,11/27/2018,0,1,17862,0,-62,0.291759789,0.708240241,-1,62,5147,180,111,62,7391
224,11/28/2018,0,1,17863,0,264,0.373629019,0.626370996,-1,-264,4883,57,374,-200,7191
225,11/29/2018,1,0,17864,1,-271,0.500792295,0.49920769,1,-271,4612,278,86,-200,6991
226,11/30/2018,1,0,17865,1,-149,0.694103688,0.305896282,1,-149,4463,263,50,-200,6791
227,12/3/2018,0,1,17868,0,146,0.47768189,0.522318125,-1,-146,4317,110,188,-146,6645
228,12/4/2018,0,1,17869,0,161,0.339497194,0.660502821,-1,-161,4156,69,187,-161,6484
229,12/5/2018,1,0,17870,1,-23,0.679792404,0.320207566,1,-23,4133,64,160,-23,6461
230,12/6/2018,0,1,17871,0,-334,0.475084975,0.52491504,-1,334,4467,488,0,334,6795
231,12/7/2018,1,0,17872,1,-186,0.694051743,0.305948257,1,-186,4281,253,47,-200,6595
232,12/10/2018,1,0,17875,1,-55,0.629552007,0.370447949,1,-55,4226,217,66,-200,6395
233,12/11/2018,1,0,17876,1,53,0.508654177,0.491345853,1,53,4279,96,200,53,6448
234,12/12/2018,0,1,17877,0,199,0.390889406,0.609110624,-1,-199,4080,43,236,-200,6248
235,12/13/2018,0,1,17878,0,139,0.330391079,0.669608951,-1,-139,3941,78,236,-200,6048
236,12/14/2018,1,0,17879,1,-171,0.674390525,0.325609475,1,-171,3770,191,28,-171,5877
237,12/17/2018,1,0,17882,1,-98,0.659604371,0.340395659,1,-98,3672,165,56,-98,5779
238,12/18/2018,1,0,17883,1,-61,0.589999825,0.410000145,1,-61,3611,181,312,-61,5718
239,12/19/2018,1,0,17884,1,73,0.648409843,0.351590186,1,73,3684,48,90,73,5791
240,12/20/2018,1,0,17885,1,-266,0.59536165,0.404638395,1,-266,3418,426,74,-200,5591
241,12/21/2018,1,0,17886,1,188,0.570914805,0.42908518,1,188,3606,162,324,188,5779
242,12/24/2018,1,0,17889,1,126,0.623522341,0.376477629,1,126,3732,100,158,126,5905
243,12/27/2018,0,1,17892,0,-486,0.421917886,0.578082114,-1,486,4218,558,60,486,6391
244,12/28/2018,1,0,17893,1,6,0.688875914,0.311124116,1,6,4224,76,86,6,6397
245,12/31/2018,1,0,17896,1,-14,0.676796168,0.323203847,1,-14,4210,158,132,-14,6383
